State,County,Agency,Ori,total aggravated-assault crimes (2015-2023),total aggravated-assault cleared crimes (2015-2023),total aggravated-assault actual crimes (2015-2023),total violent-crime crimes (2015-2023),total violent-crime cleared crimes (2015-2023),total violent-crime actual crimes (2015-2023),total arson crimes (2015-2023),total arson cleared crimes (2015-2023),total arson actual crimes (2015-2023),total human-trafficing crimes (2015-2023),total human-trafficing cleared crimes (2015-2023),total human-trafficing actual crimes (2015-2023),total rape-legacy crimes (2015-2023),total rape-legacy cleared crimes (2015-2023),total rape-legacy actual crimes (2015-2023),total homicide crimes (2015-2023),total homicide cleared crimes (2015-2023),total homicide actual crimes (2015-2023),total burglary crimes (2015-2023),total burglary cleared crimes (2015-2023),total burglary actual crimes (2015-2023),total motor-vehicle-theft crimes (2015-2023),total motor-vehicle-theft cleared crimes (2015-2023),total motor-vehicle-theft actual crimes (2015-2023),total larceny crimes (2015-2023),total larceny cleared crimes (2015-2023),total larceny actual crimes (2015-2023),total rape crimes (2015-2023),total rape cleared crimes (2015-2023),total rape actual crimes (2015-2023),total property-crime crimes (2015-2023),total property-crime cleared crimes (2015-2023),total property-crime actual crimes (2015-2023),Latitude,Longitude
West Virginia,BARBOUR,Barbour County Sheriff's Office,WV0010000,247,88,159,259,90,169,3,1,2,0,0,0,4,0,4,4,1,3,36,5,31,15,1,14,89,10,79,6,0,6,140,16,124,39.151608,-80.03847
West Virginia,BARBOUR,Belington Police Department,WV0010100,49,24,25,50,24,26,0,0,0,0,0,0,0,0,0,0,0,0,13,5,8,0,0,0,14,5,9,1,0,1,27,10,17,39.139725,-79.996947
West Virginia,BARBOUR,Philippi Police Department,WV0010200,233,61,172,253,66,187,0,0,0,0,0,0,13,3,10,0,0,0,51,4,47,10,3,7,144,25,119,19,5,14,205,32,173,39.139725,-79.996947
West Virginia,BARBOUR,Department of Natural Resources: Barbour County,WV0010300,0,0,0,0,0,0,0,0,0,0,0,0,0,0,0,0,0,0,0,0,0,0,0,0,2,1,1,0,0,0,2,1,1,39.139725,-79.996947
West Virginia,BARBOUR,State Fire Marshal: Barbour County,WV0010600,0,0,0,0,0,0,1,0,1,0,0,0,0,0,0,0,0,0,0,0,0,0,0,0,0,0,0,0,0,0,0,0,0,38.34613,-81.63015
West Virginia,BERKELEY,Berkeley County Sheriff's Office,WV0020000,657,214,443,891,253,638,32,7,25,10,3,7,91,6,85,30,11,19,900,69,831,196,30,166,3183,385,2798,139,15,124,4279,484,3795,39.45025,-77.96581
West Virginia,BERKELEY,Martinsburg Police Department,WV0020100,588,249,339,812,308,504,46,14,32,0,0,0,61,11,50,10,4,6,467,72,395,109,19,90,5967,2173,3794,93,17,76,6543,2264,4279,39.459187,-77.963066
West Virginia,BERKELEY,Department of Natural Resources: Berkeley County,WV0020200,0,0,0,0,0,0,0,0,0,0,0,0,0,0,0,0,0,0,0,0,0,0,0,0,6,3,3,0,0,0,6,3,3,39.448053,-78.037807
West Virginia,BERKELEY,State Fire Marshal: Berkeley County,WV0020300,0,0,0,0,0,0,7,1,6,0,0,0,0,0,0,0,0,0,0,0,0,0,0,0,0,0,0,0,0,0,0,0,0,38.34613,-81.63015
West Virginia,BERKELEY,Eastern Panhandle Drug and Violent Crime Task Force,WV0020600,0,0,0,0,0,0,0,0,0,0,0,0,0,0,0,0,0,0,0,0,0,0,0,0,0,0,0,0,0,0,0,0,0,39.448053,-78.037807
West Virginia,BOONE,Boone County Sheriff's Office,WV0030000,76,24,52,88,26,62,12,3,9,0,0,0,6,2,4,2,0,2,86,3,83,36,5,31,133,10,123,9,2,7,255,18,237,38.06635,-81.819725
West Virginia,BOONE,Madison Police Department,WV0030100,41,11,30,49,13,36,8,1,7,1,0,1,2,1,1,2,1,1,93,17,76,29,2,27,191,25,166,4,1,3,313,44,269,38.059093,-81.820404
West Virginia,BOONE,Whitesville Police Department,WV0030200,0,0,0,0,0,0,0,0,0,0,0,0,0,0,0,0,0,0,0,0,0,0,0,0,0,0,0,0,0,0,0,0,0,38.022838,-81.713314
West Virginia,BOONE,Department of Natural Resources: Boone County,WV0030300,0,0,0,0,0,0,0,0,0,0,0,0,0,0,0,0,0,0,0,0,0,0,0,0,0,0,0,0,0,0,0,0,0,37.756214,-81.215546
West Virginia,BOONE,Danville Police Department,WV0030500,0,0,0,0,0,0,0,0,0,0,0,0,0,0,0,0,0,0,0,0,0,0,0,0,0,0,0,0,0,0,0,0,0,38.022838,-81.713314
West Virginia,BOONE,Sylvester Police Department,WV0030600,0,0,0,0,0,0,0,0,0,0,0,0,0,0,0,0,0,0,0,0,0,0,0,0,0,0,0,0,0,0,0,0,0,38.022838,-81.713314
West Virginia,BOONE,State Fire Marshal: Boone County,WV0030700,0,0,0,0,0,0,0,0,0,0,0,0,0,0,0,0,0,0,0,0,0,0,0,0,0,0,0,0,0,0,0,0,0,38.34613,-81.63015
West Virginia,BRAXTON,Braxton County Sheriff's Office,WV0040000,91,43,48,93,43,50,0,0,0,0,0,0,0,0,0,2,0,2,30,7,23,9,4,5,65,23,42,0,0,0,104,34,70,38.699302,-80.731649
West Virginia,BRAXTON,Gassaway Police Department,WV0040100,0,0,0,0,0,0,0,0,0,0,0,0,0,0,0,0,0,0,2,1,1,0,0,0,4,2,2,0,0,0,6,3,3,38.699302,-80.731649
West Virginia,BRAXTON,Sutton Police Department,WV0040200,0,0,0,0,0,0,0,0,0,0,0,0,0,0,0,0,0,0,0,0,0,0,0,0,0,0,0,0,0,0,0,0,0,38.699302,-80.731649
West Virginia,BRAXTON,Burnsville Police Department,WV0040300,0,0,0,0,0,0,0,0,0,0,0,0,0,0,0,0,0,0,0,0,0,0,0,0,0,0,0,0,0,0,0,0,0,38.699302,-80.731649
West Virginia,BRAXTON,Department of Natural Resources: Braxton County,WV0040400,0,0,0,0,0,0,0,0,0,0,0,0,0,0,0,0,0,0,0,0,0,0,0,0,0,0,0,0,0,0,0,0,0,38.699302,-80.731649
West Virginia,BRAXTON,State Fire Marshal: Braxton County,WV0040700,0,0,0,0,0,0,0,0,0,0,0,0,0,0,0,0,0,0,0,0,0,0,0,0,0,0,0,0,0,0,0,0,0,38.699302,-80.731649
West Virginia,BROOKE,Brooke County Sheriff's Office,WV0050000,38,15,23,56,21,35,12,5,7,0,0,0,9,2,7,2,1,1,122,20,102,30,7,23,196,44,152,13,4,9,348,71,277,40.269424,-80.61393
West Virginia,BROOKE,Follansbee Police Department,WV0050100,2,1,1,2,1,1,2,1,1,0,0,0,0,0,0,0,0,0,14,5,9,7,3,4,37,10,27,0,0,0,58,18,40,40.272645,-80.578691
West Virginia,BROOKE,Wellsburg Police Department,WV0050200,12,6,6,21,10,11,6,2,4,0,0,0,0,0,0,2,1,1,48,15,33,18,7,11,211,82,129,0,0,0,277,104,173,40.272645,-80.578691
West Virginia,BROOKE,Department of Natural Resources: Brooke County,WV0050300,0,0,0,0,0,0,0,0,0,0,0,0,0,0,0,0,0,0,0,0,0,0,0,0,0,0,0,0,0,0,0,0,0,40.272645,-80.578691
West Virginia,BROOKE,Bethany Police Department,WV0050500,0,0,0,0,0,0,0,0,0,0,0,0,0,0,0,0,0,0,0,0,0,0,0,0,0,0,0,0,0,0,0,0,0,40.272645,-80.578691
West Virginia,BROOKE,State Fire Marshal: Brooke County,WV0050700,0,0,0,0,0,0,0,0,0,0,0,0,0,0,0,0,0,0,0,0,0,0,0,0,0,0,0,0,0,0,0,0,0,38.34613,-81.63015
West Virginia,BROOKE,Beech Bottom Police Department,WV0050800,0,0,0,0,0,0,0,0,0,0,0,0,0,0,0,0,0,0,3,1,2,0,0,0,7,2,5,0,0,0,10,3,7,40.272645,-80.578691
West Virginia,BROOKE,Windsor Heights,WV0050900,0,0,0,0,0,0,0,0,0,0,0,0,0,0,0,0,0,0,0,0,0,0,0,0,0,0,0,0,0,0,0,0,0,40.272645,-80.578691
West Virginia,CABELL,Cabell County Sheriff's Office,WV0060000,198,49,149,260,58,202,16,4,12,0,0,0,29,3,26,1,0,1,590,34,556,160,14,146,3404,734,2670,35,4,31,4154,782,3372,38.419578,-82.243397
West Virginia,CABELL,Barboursville Police Department,WV0060100,4,0,4,24,6,18,0,0,0,0,0,0,7,3,4,0,0,0,100,9,91,22,1,21,2150,667,1483,8,3,5,2272,677,1595,38.419578,-82.243397
West Virginia,"CABELL, WAYNE",Huntington Police Department,WV0060200,1999,399,1600,3063,526,2537,158,14,144,0,0,0,262,12,250,90,29,61,3632,296,3336,1231,67,1164,9083,695,8388,323,16,307,13946,1058,12888,38.419578,-82.243397
West Virginia,CABELL,Milton Police Department,WV0060300,27,8,19,36,10,26,0,0,0,0,0,0,2,0,2,0,0,0,63,8,55,18,3,15,285,43,242,4,0,4,366,54,312,38.43637,-82.1328
West Virginia,CABELL,Marshall University,WV0060400,105,27,78,120,29,91,0,0,0,0,0,0,7,2,5,0,0,0,57,5,52,9,0,9,324,36,288,9,2,7,390,41,349,38.422318,-82.426544
West Virginia,CABELL,Department of Natural Resources: Cabell County,WV0060500,0,0,0,0,0,0,0,0,0,0,0,0,0,0,0,0,0,0,0,0,0,0,0,0,0,0,0,0,0,0,0,0,0,38.444405,-81.831314
West Virginia,CABELL,State Fire Marshal: Cabell County,WV0060800,0,0,0,0,0,0,0,0,0,0,0,0,0,0,0,0,0,0,0,0,0,0,0,0,0,0,0,0,0,0,0,0,0,38.34613,-81.63015
West Virginia,CABELL,Huntington Drug and Violent Crime Task Force,WV0061000,0,0,0,6,3,3,0,0,0,0,0,0,0,0,0,0,0,0,2,1,1,0,0,0,0,0,0,0,0,0,2,1,1,38.419578,-82.243397
West Virginia,CALHOUN,Calhoun County Sheriff's Office,WV0070000,4,2,2,6,2,4,1,0,1,0,0,0,0,0,0,0,0,0,27,2,25,17,6,11,68,10,58,1,0,1,112,18,94,38.844159,-81.115478
West Virginia,CALHOUN,Grantsville Police Department,WV0070100,0,0,0,0,0,0,0,0,0,0,0,0,0,0,0,0,0,0,0,0,0,0,0,0,0,0,0,0,0,0,0,0,0,38.844159,-81.115478
West Virginia,CALHOUN,Department of Natural Resources: Calhoun County,WV0070200,0,0,0,0,0,0,0,0,0,0,0,0,0,0,0,0,0,0,0,0,0,0,0,0,0,0,0,0,0,0,0,0,0,38.444405,-81.831314
West Virginia,CALHOUN,State Fire Marshal: Calhoun County,WV0070300,0,0,0,0,0,0,0,0,0,0,0,0,0,0,0,0,0,0,0,0,0,0,0,0,0,0,0,0,0,0,0,0,0,38.34613,-81.63015
West Virginia,CLAY,Clay County Sheriff's Office,WV0080000,0,0,0,0,0,0,0,0,0,0,0,0,0,0,0,0,0,0,0,0,0,0,0,0,0,0,0,0,0,0,0,0,0,38.459826,-81.081866
West Virginia,CLAY,Department of Natural Resources: Clay County,WV0080200,0,0,0,0,0,0,0,0,0,0,0,0,0,0,0,0,0,0,0,0,0,0,0,0,0,0,0,0,0,0,0,0,0,38.459826,-81.081866
West Virginia,CLAY,State Fire Marshal: Clay County,WV0080300,0,0,0,0,0,0,0,0,0,0,0,0,0,0,0,0,0,0,0,0,0,0,0,0,0,0,0,0,0,0,0,0,0,38.34613,-81.63015
West Virginia,DODDRIDGE,Doddridge County Sheriff's Office,WV0090000,74,26,48,88,30,58,7,0,7,1,0,1,8,3,5,1,0,1,100,15,85,26,4,22,154,23,131,10,3,7,280,42,238,39.263482,-80.701147
West Virginia,DODDRIDGE,West Union Police Department,WV0090100,0,0,0,0,0,0,0,0,0,0,0,0,0,0,0,0,0,0,0,0,0,0,0,0,4,1,3,0,0,0,4,1,3,39.263482,-80.701147
West Virginia,DODDRIDGE,Department of Natural Resources: Doddridge County,WV0090200,0,0,0,0,0,0,0,0,0,0,0,0,0,0,0,0,0,0,0,0,0,0,0,0,0,0,0,0,0,0,0,0,0,39.282536,-81.549706
West Virginia,DODDRIDGE,State Fire Marshal: Doddridge County,WV0090300,0,0,0,0,0,0,1,0,1,0,0,0,0,0,0,0,0,0,0,0,0,0,0,0,0,0,0,0,0,0,0,0,0,38.34613,-81.63015
West Virginia,FAYETTE,Fayette County Sheriff's Office,WV0100000,687,246,441,794,263,531,32,5,27,0,0,0,38,5,33,18,4,14,779,96,683,242,27,215,1218,125,1093,59,6,53,2239,248,1991,38.030933,-81.086051
West Virginia,FAYETTE,Ansted Police Department,WV0100100,0,0,0,0,0,0,0,0,0,0,0,0,0,0,0,0,0,0,0,0,0,0,0,0,1,0,1,0,0,0,1,0,1,38.030933,-81.086051
West Virginia,FAYETTE,Fayetteville Police Department,WV0100200,49,20,29,56,22,34,2,0,2,0,0,0,1,0,1,0,0,0,64,9,55,23,8,15,1366,561,805,4,1,3,1453,578,875,38.030933,-81.086051
West Virginia,"FAYETTE, KANAWHA",Montgomery Police Department,WV0100300,0,0,0,0,0,0,0,0,0,0,0,0,0,0,0,0,0,0,0,0,0,0,0,0,0,0,0,0,0,0,0,0,0,38.180664,-81.32927
West Virginia,FAYETTE,Mount Hope Police Department,WV0100400,12,5,7,15,6,9,0,0,0,0,0,0,0,0,0,0,0,0,14,1,13,3,0,3,51,7,44,0,0,0,68,8,60,38.030933,-81.086051
West Virginia,FAYETTE,Oak Hill Police Department,WV0100500,81,27,54,111,32,79,7,1,6,0,0,0,12,2,10,4,1,3,214,21,193,38,3,35,937,260,677,18,3,15,1189,284,905,38.030933,-81.086051
West Virginia,FAYETTE,Department of Natural Resources: Fayette County,WV0101000,4,2,2,4,2,2,0,0,0,0,0,0,0,0,0,0,0,0,0,0,0,0,0,0,0,0,0,0,0,0,0,0,0,37.756214,-81.215546
West Virginia,FAYETTE,Gauley Bridge Police Department,WV0101100,0,0,0,0,0,0,0,0,0,0,0,0,0,0,0,0,0,0,0,0,0,0,0,0,0,0,0,0,0,0,0,0,0,38.030933,-81.086051
West Virginia,FAYETTE,State Fire Marshal: Fayette County,WV0101500,0,0,0,0,0,0,0,0,0,0,0,0,0,0,0,0,0,0,0,0,0,0,0,0,0,0,0,0,0,0,0,0,0,38.030933,-81.086051
West Virginia,GILMER,Gilmer County Sheriff's Office,WV0110000,4,2,2,4,2,2,0,0,0,0,0,0,0,0,0,0,0,0,6,2,4,13,5,8,39,8,31,0,0,0,58,15,43,38.93437,-80.83701
West Virginia,GILMER,Glenville Police Department,WV0110100,14,7,7,14,7,7,0,0,0,0,0,0,0,0,0,0,0,0,0,0,0,0,0,0,4,2,2,0,0,0,4,2,2,38.933693,-80.837036
West Virginia,GILMER,Glenville State College,WV0110200,2,1,1,2,1,1,0,0,0,0,0,0,0,0,0,0,0,0,7,1,6,0,0,0,17,3,14,0,0,0,24,4,20,38.915865,-80.849409
West Virginia,GILMER,Department of Natural Resources: Gilmer County,WV0110300,0,0,0,0,0,0,0,0,0,0,0,0,0,0,0,0,0,0,0,0,0,0,0,0,0,0,0,0,0,0,0,0,0,38.915865,-80.849409
West Virginia,GILMER,State Fire Marshal: Gilmer County,WV0110600,0,0,0,0,0,0,2,1,1,0,0,0,0,0,0,0,0,0,0,0,0,0,0,0,0,0,0,0,0,0,0,0,0,38.34613,-81.63015
West Virginia,GRANT,Grant County Sheriff's Office,WV0120000,81,39,42,87,41,46,0,0,0,0,0,0,3,1,2,2,1,1,21,6,15,5,2,3,47,14,33,4,1,3,73,22,51,39.105988,-79.195064
West Virginia,GRANT,Petersburg Police Department,WV0120100,0,0,0,0,0,0,0,0,0,0,0,0,0,0,0,0,0,0,0,0,0,0,0,0,0,0,0,0,0,0,0,0,0,39.105988,-79.195064
West Virginia,GRANT,Department of Natural Resources: Grant County,WV0120200,0,0,0,0,0,0,2,1,1,0,0,0,0,0,0,0,0,0,0,0,0,0,0,0,4,2,2,0,0,0,4,2,2,39.105988,-79.195064
West Virginia,GRANT,Bayard Police Department,WV0120300,0,0,0,0,0,0,0,0,0,0,0,0,0,0,0,0,0,0,0,0,0,0,0,0,0,0,0,0,0,0,0,0,0,39.105988,-79.195064
West Virginia,GRANT,State Fire Marshal: Grant County,WV0120400,0,0,0,0,0,0,0,0,0,0,0,0,0,0,0,0,0,0,0,0,0,0,0,0,0,0,0,0,0,0,0,0,0,39.105988,-79.195064
West Virginia,GRANT,Potomac Highlands Drug and Violent Crime Task Force,WV0120500,0,0,0,0,0,0,0,0,0,0,0,0,0,0,0,0,0,0,0,0,0,0,0,0,0,0,0,0,0,0,0,0,0,39.105988,-79.195064
West Virginia,GREENBRIER,Greenbrier County Sheriff's Office,WV0130000,48,17,31,62,18,44,4,1,3,0,0,0,1,0,1,3,0,3,186,10,176,53,4,49,278,7,271,3,0,3,517,21,496,37.924418,-80.45059
West Virginia,GREENBRIER,Lewisburg Police Department,WV0130100,38,17,21,38,17,21,2,1,1,0,0,0,0,0,0,0,0,0,19,8,11,24,11,13,1152,537,615,0,0,0,1195,556,639,37.924418,-80.45059
West Virginia,GREENBRIER,Rainelle Police Department,WV0130200,0,0,0,0,0,0,0,0,0,0,0,0,0,0,0,0,0,0,0,0,0,0,0,0,0,0,0,0,0,0,0,0,0,37.924418,-80.45059
West Virginia,GREENBRIER,Ronceverte Police Department,WV0130300,21,10,11,25,12,13,1,0,1,0,0,0,0,0,0,0,0,0,9,2,7,14,5,9,75,15,60,4,2,2,98,22,76,37.924418,-80.45059
West Virginia,GREENBRIER,White Sulphur Springs Police Department,WV0130400,25,10,15,32,11,21,0,0,0,0,0,0,3,1,2,0,0,0,15,3,12,8,1,7,31,4,27,3,1,2,54,8,46,37.924418,-80.45059
West Virginia,GREENBRIER,Department of Natural Resources: Greenbrier County,WV0130600,0,0,0,0,0,0,0,0,0,0,0,0,0,0,0,0,0,0,0,0,0,0,0,0,0,0,0,0,0,0,0,0,0,37.756214,-81.215546
West Virginia,GREENBRIER,Rupert Police Department,WV0130700,2,1,1,2,1,1,0,0,0,0,0,0,0,0,0,0,0,0,0,0,0,0,0,0,0,0,0,0,0,0,0,0,0,37.924418,-80.45059
West Virginia,GREENBRIER,State Fire Marshal: Greenbrier County,WV0131000,0,0,0,0,0,0,0,0,0,0,0,0,0,0,0,0,0,0,0,0,0,0,0,0,0,0,0,0,0,0,0,0,0,37.924418,-80.45059
West Virginia,GREENBRIER,Greenbrier County Drug and Violent Crime Task Force,WV0131100,0,0,0,0,0,0,0,0,0,0,0,0,0,0,0,0,0,0,0,0,0,0,0,0,0,0,0,0,0,0,0,0,0,37.924418,-80.45059
West Virginia,HAMPSHIRE,Hampshire County Sheriff's Office,WV0140000,149,45,104,161,50,111,6,2,4,0,0,0,3,1,2,6,3,3,278,35,243,56,10,46,393,52,341,3,1,2,727,97,630,39.341347,-78.756805
West Virginia,HAMPSHIRE,Romney Police Department,WV0140100,122,53,69,124,53,71,0,0,0,0,0,0,2,0,2,0,0,0,8,2,6,6,1,5,21,6,15,2,0,2,35,9,26,39.34002,-78.752266
West Virginia,HAMPSHIRE,Department of Natural Resources: Hampshire County,WV0140200,0,0,0,0,0,0,0,0,0,0,0,0,0,0,0,0,0,0,0,0,0,0,0,0,2,1,1,0,0,0,2,1,1,39.312139,-78.611989
West Virginia,HAMPSHIRE,Capon Bridge Police Department,WV0140500,0,0,0,0,0,0,0,0,0,0,0,0,0,0,0,0,0,0,0,0,0,0,0,0,0,0,0,0,0,0,0,0,0,39.312139,-78.611989
West Virginia,HAMPSHIRE,State Fire Marshal: Hampshire County,WV0140600,0,0,0,0,0,0,1,0,1,0,0,0,0,0,0,0,0,0,0,0,0,0,0,0,0,0,0,0,0,0,0,0,0,38.34613,-81.63015
West Virginia,HANCOCK,Hancock County Sheriff's Office,WV0150000,60,18,42,83,21,62,4,1,3,0,0,0,7,1,6,3,0,3,67,3,64,17,2,15,112,10,102,14,2,12,196,15,181,40.516958,-80.570164
West Virginia,HANCOCK,Chester Police Department,WV0150100,5,0,5,5,0,5,0,0,0,0,0,0,0,0,0,0,0,0,0,0,0,3,0,3,10,1,9,0,0,0,13,1,12,40.516958,-80.570164
West Virginia,"BROOKE, HANCOCK",Weirton Police Department,WV0150200,127,49,78,197,64,133,28,8,20,0,0,0,24,4,20,8,4,4,185,33,152,64,14,50,1461,570,891,38,6,32,1710,617,1093,40.4022,-80.58772
West Virginia,HANCOCK,New Cumberland Police Department,WV0150300,0,0,0,0,0,0,0,0,0,0,0,0,0,0,0,0,0,0,0,0,0,0,0,0,0,0,0,0,0,0,0,0,0,40.516958,-80.570164
West Virginia,HANCOCK,Department of Natural Resources: Hancock County,WV0150400,0,0,0,0,0,0,0,0,0,0,0,0,0,0,0,0,0,0,0,0,0,0,0,0,0,0,0,0,0,0,0,0,0,40.516958,-80.570164
West Virginia,HANCOCK,State Fire Marshal: Hancock County,WV0150500,0,0,0,0,0,0,0,0,0,0,0,0,0,0,0,0,0,0,0,0,0,0,0,0,0,0,0,0,0,0,0,0,0,38.34613,-81.63015
West Virginia,HANCOCK,Hancock/Brooke/Weirton Drug Task Force,WV0150700,0,0,0,3,1,2,0,0,0,0,0,0,0,0,0,3,1,2,2,1,1,0,0,0,0,0,0,0,0,0,2,1,1,40.516958,-80.570164
West Virginia,HARDY,Hardy County Sheriff's Office,WV0160000,228,99,129,238,103,135,0,0,0,0,0,0,5,2,3,3,1,2,36,6,30,25,8,17,73,15,58,5,2,3,134,29,105,39.010818,-78.843641
West Virginia,HARDY,Moorefield Police Department,WV0160100,361,158,203,379,165,214,2,1,1,0,0,0,9,3,6,2,1,1,62,17,45,23,7,16,810,229,581,14,5,9,895,253,642,39.062195,-78.968025
West Virginia,HARDY,Department of Natural Resources: Hardy County,WV0160300,0,0,0,0,0,0,0,0,0,0,0,0,0,0,0,0,0,0,0,0,0,0,0,0,0,0,0,0,0,0,0,0,0,39.010818,-78.843641
West Virginia,HARDY,State Fire Marshal: Hardy County,WV0160600,0,0,0,0,0,0,0,0,0,0,0,0,0,0,0,0,0,0,0,0,0,0,0,0,0,0,0,0,0,0,0,0,0,38.34613,-81.63015
West Virginia,HARRISON,Harrison County Sheriff's Office,WV0170000,372,119,253,501,149,352,31,5,26,2,0,2,38,5,33,15,6,9,381,41,340,204,24,180,910,100,810,91,19,72,1495,165,1330,39.263905,-80.326675
West Virginia,HARRISON,Bridgeport Police Department,WV0170100,135,32,103,172,36,136,8,1,7,14,4,10,14,1,13,2,1,1,105,16,89,57,16,41,1545,405,1140,25,1,24,1707,437,1270,39.280823,-80.25987
West Virginia,HARRISON,Clarksburg Police Department,WV0170200,202,68,134,269,74,195,12,1,11,1,0,1,15,0,15,0,0,0,155,26,129,91,9,82,2285,580,1705,55,3,52,2531,615,1916,39.27901,-80.338196
West Virginia,HARRISON,Salem Police Department,WV0170300,0,0,0,0,0,0,0,0,0,0,0,0,0,0,0,0,0,0,0,0,0,0,0,0,0,0,0,0,0,0,0,0,0,39.279182,-80.386498
West Virginia,HARRISON,Shinnston Police Department,WV0170400,37,7,30,38,7,31,1,0,1,0,0,0,0,0,0,0,0,0,17,0,17,2,0,2,86,16,70,1,0,1,105,16,89,39.396294,-80.301025
West Virginia,HARRISON,Stonewood Police Department,WV0170500,0,0,0,0,0,0,0,0,0,0,0,0,0,0,0,0,0,0,0,0,0,1,0,1,8,1,7,0,0,0,9,1,8,39.251194,-80.31329
West Virginia,HARRISON,Anmoore Police Department,WV0170600,0,0,0,0,0,0,0,0,0,0,0,0,0,0,0,0,0,0,0,0,0,0,0,0,2,0,2,0,0,0,2,0,2,39.279182,-80.386498
West Virginia,HARRISON,Nutter Fort Police Department,WV0170700,2,1,1,2,1,1,0,0,0,0,0,0,0,0,0,0,0,0,2,0,2,1,0,1,22,3,19,0,0,0,25,3,22,39.258904,-80.323166
West Virginia,HARRISON,Lumberport Police Department,WV0170800,0,0,0,0,0,0,0,0,0,0,0,0,0,0,0,0,0,0,0,0,0,0,0,0,0,0,0,0,0,0,0,0,0,39.279182,-80.386498
West Virginia,HARRISON,West Milford Police Department,WV0171000,0,0,0,0,0,0,0,0,0,0,0,0,0,0,0,0,0,0,0,0,0,0,0,0,0,0,0,0,0,0,0,0,0,39.279182,-80.386498
West Virginia,HARRISON,Department of Natural Resources: Harrison County,WV0171100,0,0,0,0,0,0,0,0,0,0,0,0,0,0,0,0,0,0,0,0,0,0,0,0,0,0,0,0,0,0,0,0,0,39.279182,-80.386498
West Virginia,HARRISON,State Fire Marshal: Harrison County,WV0171200,0,0,0,0,0,0,3,1,2,0,0,0,0,0,0,0,0,0,0,0,0,0,0,0,0,0,0,0,0,0,0,0,0,38.34613,-81.63015
West Virginia,HARRISON,Harrison County Drug and Violent Crime Task Force,WV0171400,0,0,0,0,0,0,0,0,0,0,0,0,0,0,0,0,0,0,0,0,0,0,0,0,0,0,0,0,0,0,0,0,0,39.263905,-80.326675
West Virginia,JACKSON,Jackson County Sheriff's Office,WV0180000,809,351,458,860,369,491,6,3,3,0,0,0,35,12,23,10,4,6,168,45,123,69,19,50,237,51,186,40,14,26,474,115,359,38.834234,-81.677717
West Virginia,JACKSON,Ravenswood Police Department,WV0180100,170,60,110,177,61,116,0,0,0,0,0,0,3,0,3,0,0,0,50,6,44,14,4,10,211,14,197,3,0,3,275,24,251,38.95125,-81.76154
West Virginia,JACKSON,Ripley Police Department,WV0180200,64,23,41,70,24,46,0,0,0,0,0,0,1,0,1,0,0,0,15,4,11,1,0,1,162,41,121,2,0,2,178,45,133,38.834234,-81.677717
West Virginia,JACKSON,Department of Natural Resources: Jackson County,WV0180300,0,0,0,0,0,0,0,0,0,0,0,0,0,0,0,0,0,0,0,0,0,0,0,0,0,0,0,0,0,0,0,0,0,38.834234,-81.677717
West Virginia,JACKSON,State Fire Marshal: Jackson County,WV0180500,0,0,0,0,0,0,7,2,5,0,0,0,0,0,0,0,0,0,0,0,0,0,0,0,0,0,0,0,0,0,0,0,0,38.34613,-81.63015
West Virginia,JEFFERSON,Jefferson County Sheriff's Office,WV0190000,247,86,161,374,112,262,15,2,13,0,0,0,59,9,50,11,4,7,572,66,506,166,28,138,1900,338,1562,80,13,67,2638,432,2206,39.307398,-77.86322
West Virginia,JEFFERSON,Charles Town Police Department,WV0190100,69,32,37,131,58,73,2,0,2,0,0,0,9,4,5,6,3,3,282,39,243,27,7,20,417,97,320,24,11,13,726,143,583,39.307398,-77.86322
West Virginia,JEFFERSON,Shepherdstown Police Department,WV0190200,4,0,4,5,0,5,0,0,0,0,0,0,1,0,1,0,0,0,6,0,6,3,1,2,29,6,23,1,0,1,38,7,31,39.307398,-77.86322
West Virginia,JEFFERSON,Ranson Police Department,WV0190300,55,0,55,75,0,75,3,0,3,0,0,0,3,0,3,1,0,1,73,3,70,19,1,18,337,16,321,5,0,5,429,20,409,39.307398,-77.86322
West Virginia,JEFFERSON,Harpers Ferry/Bolivar Police Department,WV0190400,0,0,0,0,0,0,0,0,0,0,0,0,0,0,0,0,0,0,0,0,0,0,0,0,0,0,0,0,0,0,0,0,0,39.307398,-77.86322
West Virginia,JEFFERSON,Department of Natural Resources: Jefferson County,WV0190500,0,0,0,0,0,0,0,0,0,0,0,0,0,0,0,0,0,0,0,0,0,0,0,0,0,0,0,0,0,0,0,0,0,39.307398,-77.86322
West Virginia,JEFFERSON,Shepherd University,WV0190700,1,0,1,12,1,11,0,0,0,0,0,0,7,0,7,0,0,0,4,0,4,0,0,0,43,0,43,11,1,10,47,0,47,39.307398,-77.86322
West Virginia,JEFFERSON,State Fire Marshal: Jefferson County,WV0190800,0,0,0,0,0,0,4,1,3,0,0,0,0,0,0,0,0,0,0,0,0,0,0,0,0,0,0,0,0,0,0,0,0,38.34613,-81.63015
West Virginia,KANAWHA,Kanawha County Sheriff's Office,WV0200000,2824,621,2203,3376,699,2677,128,8,120,19,4,15,69,4,65,74,22,52,3363,230,3133,1781,87,1694,5821,358,5463,347,32,315,10965,675,10290,38.352394,-81.63982
West Virginia,KANAWHA,Belle Police Department,WV0200100,0,0,0,0,0,0,0,0,0,0,0,0,0,0,0,0,0,0,0,0,0,0,0,0,0,0,0,0,0,0,0,0,0,38.23045,-81.535774
West Virginia,KANAWHA,Charleston Police Department,WV0200200,3633,946,2687,4854,1122,3732,249,31,218,0,0,0,238,20,218,114,33,81,5515,591,4924,1953,129,1824,18189,3319,14870,392,34,358,25657,4039,21618,38.328061,-81.523522
West Virginia,KANAWHA,Dunbar Police Department,WV0200300,387,97,290,473,108,365,27,4,23,0,0,0,5,0,5,4,1,3,488,46,442,215,7,208,1351,169,1182,32,2,30,2054,222,1832,38.328061,-81.523522
West Virginia,"KANAWHA, PUTNAM",Nitro Police Department,WV0200400,137,30,107,169,32,137,6,1,5,0,0,0,2,0,2,0,0,0,208,16,192,113,3,110,2147,393,1754,20,2,18,2468,412,2056,38.328061,-81.523522
West Virginia,KANAWHA,St. Albans Police Department,WV0200500,285,108,177,354,121,233,4,1,3,0,0,0,4,0,4,4,1,3,529,66,463,207,13,194,2247,487,1760,27,2,25,2983,566,2417,38.38691,-81.83757
West Virginia,KANAWHA,South Charleston Police Department,WV0200600,636,172,464,749,186,563,27,3,24,0,0,0,7,1,6,6,1,5,615,65,550,370,32,338,6997,2109,4888,53,2,51,7982,2206,5776,38.365562,-81.69602
West Virginia,KANAWHA,Chesapeake Police Department,WV0200700,0,0,0,0,0,0,0,0,0,0,0,0,0,0,0,0,0,0,0,0,0,0,0,0,0,0,0,0,0,0,0,0,0,38.223957,-81.53694
West Virginia,KANAWHA,Marmet Police Department,WV0200800,14,5,9,16,5,11,1,0,1,0,0,0,0,0,0,0,0,0,32,3,29,17,1,16,194,22,172,0,0,0,243,26,217,38.328061,-81.523522
West Virginia,KANAWHA,East Bank Police Department,WV0201100,0,0,0,0,0,0,0,0,0,0,0,0,0,0,0,0,0,0,0,0,0,0,0,0,0,0,0,0,0,0,0,0,0,38.328061,-81.523522
West Virginia,KANAWHA,Glasgow Police Department,WV0201300,1,0,1,1,0,1,0,0,0,0,0,0,0,0,0,0,0,0,0,0,0,0,0,0,2,0,2,0,0,0,2,0,2,38.328061,-81.523522
West Virginia,KANAWHA,Clendenin Police Department,WV0201400,0,0,0,0,0,0,0,0,0,0,0,0,0,0,0,0,0,0,0,0,0,0,0,0,0,0,0,0,0,0,0,0,0,38.328061,-81.523522
West Virginia,KANAWHA,Cedar Grove Police Department,WV0201600,0,0,0,0,0,0,0,0,0,0,0,0,0,0,0,0,0,0,0,0,0,0,0,0,0,0,0,0,0,0,0,0,0,38.328061,-81.523522
West Virginia,KANAWHA,Pratt Police Department,WV0201700,0,0,0,0,0,0,0,0,0,0,0,0,0,0,0,0,0,0,0,0,0,0,0,0,0,0,0,0,0,0,0,0,0,38.328061,-81.523522
West Virginia,KANAWHA,Handley Police Department,WV0201800,0,0,0,0,0,0,0,0,0,0,0,0,0,0,0,0,0,0,0,0,0,0,0,0,0,0,0,0,0,0,0,0,0,38.328061,-81.523522
West Virginia,KANAWHA,West Virginia State University,WV0202000,9,2,7,11,2,9,1,0,1,0,0,0,0,0,0,0,0,0,19,0,19,2,0,2,65,1,64,2,0,2,86,1,85,38.328061,-81.523522
West Virginia,KANAWHA,Department of Natural Resources: Kanawha County,WV0202100,0,0,0,0,0,0,0,0,0,0,0,0,0,0,0,0,0,0,0,0,0,0,0,0,0,0,0,0,0,0,0,0,0,38.444405,-81.831314
West Virginia,KANAWHA,State Fire Marshal: Kanawha County,WV0202200,0,0,0,0,0,0,3,0,3,0,0,0,0,0,0,0,0,0,0,0,0,0,0,0,0,0,0,0,0,0,0,0,0,38.328061,-81.523522
West Virginia,KANAWHA,Kanawha County Parks and Recreation,WV0202700,0,0,0,0,0,0,0,0,0,0,0,0,0,0,0,0,0,0,3,0,3,0,0,0,6,0,6,0,0,0,9,0,9,38.38358,-81.580574
West Virginia,KANAWHA,Capitol Protective Services,WV0203400,2,1,1,2,1,1,0,0,0,0,0,0,0,0,0,0,0,0,9,1,8,3,1,2,46,5,41,0,0,0,58,7,51,38.335526,-81.612915
West Virginia,KANAWHA,Metropolitan Drug Enforcement Network Team,WV0203600,2,1,1,2,1,1,0,0,0,0,0,0,0,0,0,0,0,0,0,0,0,0,0,0,2,0,2,0,0,0,2,0,2,38.328061,-81.523522
West Virginia,LEWIS,Lewis County Sheriff's Office,WV0210000,59,22,37,66,23,43,9,4,5,0,0,0,1,0,1,4,1,3,72,10,62,42,5,37,174,30,144,2,0,2,288,45,243,39.03698,-80.466805
West Virginia,LEWIS,Weston Police Department,WV0210100,52,26,26,54,27,27,0,0,0,0,0,0,0,0,0,0,0,0,4,2,2,12,6,6,54,27,27,0,0,0,70,35,35,38.988877,-80.495477
West Virginia,LEWIS,Department of Natural Resources: Lewis County,WV0210200,0,0,0,0,0,0,0,0,0,0,0,0,0,0,0,0,0,0,0,0,0,0,0,0,0,0,0,0,0,0,0,0,0,38.988877,-80.495477
West Virginia,LEWIS,State Fire Marshal: Lewis County,WV0210300,0,0,0,0,0,0,0,0,0,0,0,0,0,0,0,0,0,0,0,0,0,0,0,0,0,0,0,0,0,0,0,0,0,38.34613,-81.63015
West Virginia,LEWIS,Mountain Lakes Drug and Violent Crime Unit,WV0210900,0,0,0,0,0,0,0,0,0,0,0,0,0,0,0,0,0,0,0,0,0,0,0,0,0,0,0,0,0,0,0,0,0,,
West Virginia,LINCOLN,Lincoln County Sheriff's Office,WV0220000,0,0,0,0,0,0,0,0,0,0,0,0,0,0,0,0,0,0,0,0,0,0,0,0,0,0,0,0,0,0,0,0,0,38.17165,-82.077547
West Virginia,LINCOLN,Hamlin Police Department,WV0220100,6,0,6,6,0,6,0,0,0,0,0,0,0,0,0,0,0,0,3,0,3,0,0,0,15,2,13,0,0,0,18,2,16,38.17165,-82.077547
West Virginia,LINCOLN,Department of Natural Resources: Lincoln County,WV0220200,0,0,0,0,0,0,0,0,0,0,0,0,0,0,0,0,0,0,0,0,0,0,0,0,2,1,1,0,0,0,2,1,1,38.444405,-81.831314
West Virginia,LINCOLN,State Fire Marshal: Lincoln County,WV0220500,0,0,0,0,0,0,0,0,0,0,0,0,0,0,0,0,0,0,0,0,0,0,0,0,0,0,0,0,0,0,0,0,0,38.34613,-81.63015
West Virginia,LOGAN,Logan County Sheriff's Office,WV0230000,1407,552,855,1440,555,885,24,7,17,0,0,0,15,1,14,11,2,9,76,17,59,25,4,21,159,24,135,18,1,17,260,45,215,37.830591,-81.940853
West Virginia,LOGAN,Logan Police Department,WV0230100,0,0,0,0,0,0,0,0,0,0,0,0,0,0,0,0,0,0,0,0,0,0,0,0,0,0,0,0,0,0,0,0,0,37.830591,-81.940853
West Virginia,LOGAN,Man Police Department,WV0230200,0,0,0,0,0,0,0,0,0,0,0,0,0,0,0,0,0,0,0,0,0,0,0,0,0,0,0,0,0,0,0,0,0,37.830591,-81.940853
West Virginia,LOGAN,Chapmanville Police Department,WV0230300,7,3,4,13,6,7,2,1,1,0,0,0,2,1,1,2,1,1,27,10,17,7,1,6,90,20,70,2,1,1,124,31,93,37.830591,-81.940853
West Virginia,LOGAN,Department of Natural Resources: Logan County,WV0230400,0,0,0,0,0,0,0,0,0,0,0,0,0,0,0,0,0,0,0,0,0,0,0,0,0,0,0,0,0,0,0,0,0,38.444405,-81.831314
West Virginia,LOGAN,West Logan Police Department,WV0230500,0,0,0,0,0,0,0,0,0,0,0,0,0,0,0,0,0,0,0,0,0,0,0,0,0,0,0,0,0,0,0,0,0,37.830591,-81.940853
West Virginia,LOGAN,Mitchell Heights  Police Department,WV0230600,0,0,0,0,0,0,0,0,0,0,0,0,0,0,0,0,0,0,0,0,0,0,0,0,0,0,0,0,0,0,0,0,0,37.907784,-81.98252
West Virginia,LOGAN,State Fire Marshal: Logan County,WV0230800,0,0,0,0,0,0,0,0,0,0,0,0,0,0,0,0,0,0,0,0,0,0,0,0,0,0,0,0,0,0,0,0,0,37.830591,-81.940853
West Virginia,LOGAN,Logan County Drug and Violent Crime Task Force,WV0230900,2,1,1,2,1,1,2,1,1,0,0,0,0,0,0,0,0,0,0,0,0,0,0,0,2,1,1,0,0,0,2,1,1,37.841896,-82.00813
West Virginia,MCDOWELL,McDowell County Sheriff's Office,WV0240000,102,42,60,122,47,75,12,6,6,0,0,0,2,0,2,10,3,7,65,15,50,12,0,12,57,7,50,4,1,3,134,22,112,37.382663,-81.658205
West Virginia,MCDOWELL,Keystone Police Department,WV0240100,0,0,0,0,0,0,0,0,0,0,0,0,0,0,0,0,0,0,0,0,0,0,0,0,0,0,0,0,0,0,0,0,0,37.382663,-81.658205
West Virginia,MCDOWELL,War Police Department,WV0240200,0,0,0,0,0,0,0,0,0,0,0,0,0,0,0,0,0,0,0,0,0,0,0,0,0,0,0,0,0,0,0,0,0,37.382663,-81.658205
West Virginia,MCDOWELL,Welch Police Department,WV0240300,0,0,0,0,0,0,0,0,0,0,0,0,0,0,0,0,0,0,0,0,0,0,0,0,0,0,0,0,0,0,0,0,0,37.382663,-81.658205
West Virginia,MCDOWELL,Anawalt Police Department,WV0240400,0,0,0,0,0,0,0,0,0,0,0,0,0,0,0,0,0,0,0,0,0,0,0,0,0,0,0,0,0,0,0,0,0,37.382663,-81.658205
West Virginia,MCDOWELL,Gary Police Department,WV0240500,0,0,0,0,0,0,0,0,0,0,0,0,0,0,0,0,0,0,0,0,0,0,0,0,0,0,0,0,0,0,0,0,0,37.382663,-81.658205
West Virginia,MCDOWELL,Northfork Police Department,WV0240600,0,0,0,0,0,0,0,0,0,0,0,0,0,0,0,0,0,0,0,0,0,0,0,0,0,0,0,0,0,0,0,0,0,37.382663,-81.658205
West Virginia,MCDOWELL,Davy Police Department,WV0240700,0,0,0,0,0,0,0,0,0,0,0,0,0,0,0,0,0,0,0,0,0,0,0,0,0,0,0,0,0,0,0,0,0,37.382663,-81.658205
West Virginia,MCDOWELL,Kimball Police Department,WV0240800,0,0,0,0,0,0,0,0,0,0,0,0,0,0,0,0,0,0,0,0,0,0,0,0,0,0,0,0,0,0,0,0,0,37.382663,-81.658205
West Virginia,MCDOWELL,Iaeger Police Department,WV0240900,0,0,0,0,0,0,0,0,0,0,0,0,0,0,0,0,0,0,0,0,0,1,0,1,1,0,1,0,0,0,2,0,2,37.382663,-81.658205
West Virginia,MCDOWELL,Department of Natural Resources: McDowell County,WV0241000,0,0,0,0,0,0,0,0,0,0,0,0,0,0,0,0,0,0,0,0,0,0,0,0,0,0,0,0,0,0,0,0,0,37.756214,-81.215546
West Virginia,MCDOWELL,State Fire Marshal: McDowell County,WV0241100,0,0,0,0,0,0,0,0,0,0,0,0,0,0,0,0,0,0,0,0,0,0,0,0,0,0,0,0,0,0,0,0,0,38.34613,-81.63015
West Virginia,MCDOWELL,Bradshaw Police Department,WV0241200,0,0,0,0,0,0,0,0,0,0,0,0,0,0,0,0,0,0,0,0,0,0,0,0,0,0,0,0,0,0,0,0,0,37.382663,-81.658205
West Virginia,MARION,Marion County Sheriff's Office,WV0250000,605,223,382,689,247,442,9,2,7,0,0,0,36,9,27,9,2,7,327,47,280,135,22,113,663,48,615,58,17,41,1125,117,1008,39.505839,-80.243402
West Virginia,MARION,Fairmont Police Department,WV0250100,601,227,374,793,261,532,66,13,53,0,0,0,65,11,54,18,5,13,605,85,520,249,51,198,1838,418,1420,101,17,84,2692,554,2138,39.4868,-80.14081
West Virginia,MARION,Mannington Police Department,WV0250200,1,0,1,4,1,3,0,0,0,0,0,0,3,1,2,0,0,0,4,1,3,0,0,0,1,0,1,3,1,2,5,1,4,39.530766,-80.34153
West Virginia,MARION,Rivesville Police Department,WV0250300,0,0,0,0,0,0,0,0,0,0,0,0,0,0,0,0,0,0,0,0,0,0,0,0,0,0,0,0,0,0,0,0,0,39.505839,-80.243402
West Virginia,MARION,Monongah Police Department,WV0250400,12,5,7,12,5,7,0,0,0,0,0,0,0,0,0,0,0,0,0,0,0,1,0,1,15,7,8,0,0,0,16,7,9,39.505839,-80.243402
West Virginia,MARION,Fairview Police Department,WV0250500,0,0,0,0,0,0,0,0,0,0,0,0,0,0,0,0,0,0,0,0,0,0,0,0,0,0,0,0,0,0,0,0,0,39.505839,-80.243402
West Virginia,MARION,Farmington Police Department,WV0250600,0,0,0,0,0,0,0,0,0,0,0,0,0,0,0,0,0,0,0,0,0,2,1,1,2,1,1,0,0,0,4,2,2,39.505839,-80.243402
West Virginia,MARION,Grant Town Police Department,WV0250700,0,0,0,0,0,0,0,0,0,0,0,0,0,0,0,0,0,0,2,0,2,0,0,0,1,0,1,0,0,0,3,0,3,39.505839,-80.243402
West Virginia,MARION,Department of Natural Resources: Marion County,WV0250900,0,0,0,0,0,0,0,0,0,0,0,0,0,0,0,0,0,0,0,0,0,0,0,0,0,0,0,0,0,0,0,0,0,39.505839,-80.243402
West Virginia,MARION,Barrackville Police Department,WV0251100,0,0,0,0,0,0,0,0,0,0,0,0,0,0,0,0,0,0,0,0,0,0,0,0,0,0,0,0,0,0,0,0,0,39.505839,-80.243402
West Virginia,MARION,Fairmont State University,WV0251400,1,0,1,9,1,8,0,0,0,0,0,0,7,1,6,0,0,0,6,1,5,5,0,5,116,1,115,8,1,7,127,2,125,39.505839,-80.243402
West Virginia,MARION,State Fire Marshal: Marion County,WV0251500,0,0,0,0,0,0,7,2,5,0,0,0,0,0,0,0,0,0,0,0,0,0,0,0,0,0,0,0,0,0,0,0,0,38.34613,-81.63015
West Virginia,MARION,Three Rivers Drug and Violent Crime Task Force,WV0251600,2,1,1,2,1,1,0,0,0,0,0,0,0,0,0,0,0,0,0,0,0,2,1,1,0,0,0,0,0,0,2,1,1,39.4835,-80.14332
West Virginia,MARION,White Hall Police Department,WV0251700,32,15,17,35,16,19,0,0,0,0,0,0,0,0,0,0,0,0,14,4,10,6,1,5,1115,257,858,2,1,1,1135,262,873,39.41732,-80.17507
West Virginia,MARSHALL,Marshall County Sheriff's Office,WV0260000,292,119,173,316,123,193,8,2,6,0,0,0,9,1,8,1,0,1,275,19,256,78,12,66,348,23,325,21,4,17,701,54,647,39.919353,-80.74611
West Virginia,MARSHALL,Benwood Police Department,WV0260100,11,4,7,11,4,7,0,0,0,0,0,0,0,0,0,0,0,0,1,0,1,0,0,0,6,3,3,0,0,0,7,3,4,40.0192,-80.7339
West Virginia,MARSHALL,Cameron Police Department,WV0260200,1,0,1,1,0,1,0,0,0,0,0,0,0,0,0,0,0,0,6,0,6,0,0,0,15,0,15,0,0,0,21,0,21,39.854426,-80.671794
West Virginia,MARSHALL,Glen Dale Police Department,WV0260300,24,9,15,25,9,16,0,0,0,0,0,0,1,0,1,0,0,0,32,4,28,7,2,5,72,16,56,1,0,1,111,22,89,39.950905,-80.754074
West Virginia,MARSHALL,McMechen Police Department,WV0260400,5,1,4,5,1,4,0,0,0,0,0,0,0,0,0,0,0,0,1,0,1,0,0,0,4,1,3,0,0,0,5,1,4,39.988365,-80.73002
West Virginia,MARSHALL,Moundsville Police Department,WV0260500,248,82,166,310,99,211,15,1,14,0,0,0,32,9,23,3,1,2,191,26,165,60,12,48,1878,660,1218,44,11,33,2129,698,1431,39.919407,-80.74409
West Virginia,MARSHALL,Department of Natural Resources: Marshall County,WV0260600,0,0,0,0,0,0,0,0,0,0,0,0,0,0,0,0,0,0,0,0,0,0,0,0,0,0,0,0,0,0,0,0,0,39.854426,-80.671794
West Virginia,MARSHALL,State Fire Marshal: Marshall County,WV0261100,0,0,0,0,0,0,1,0,1,0,0,0,0,0,0,0,0,0,0,0,0,0,0,0,0,0,0,0,0,0,0,0,0,39.854426,-80.671794
West Virginia,MARSHALL,Marshall County Drug Task Force,WV0261200,0,0,0,4,2,2,0,0,0,0,0,0,0,0,0,4,2,2,0,0,0,0,0,0,0,0,0,0,0,0,0,0,0,,
West Virginia,MASON,Mason County Sheriff's Office,WV0270000,87,26,61,124,36,88,28,1,27,0,0,0,10,1,9,10,5,5,309,46,263,83,12,71,478,66,412,19,3,16,870,124,746,38.844597,-82.138214
West Virginia,MASON,Point Pleasant Police Department,WV0270100,28,8,20,38,9,29,5,1,4,0,0,0,6,0,6,0,0,0,101,9,92,24,1,23,380,23,357,6,0,6,505,33,472,38.84231,-82.13771
West Virginia,MASON,New Haven Police Department,WV0270200,0,0,0,0,0,0,0,0,0,0,0,0,0,0,0,0,0,0,0,0,0,0,0,0,0,0,0,0,0,0,0,0,0,38.759288,-82.024171
West Virginia,MASON,Mason Police Department,WV0270300,7,1,6,10,1,9,2,0,2,0,0,0,0,0,0,1,0,1,20,0,20,3,0,3,292,4,288,2,0,2,315,4,311,38.759288,-82.024171
West Virginia,MASON,Henderson Police Department,WV0270400,0,0,0,0,0,0,0,0,0,0,0,0,0,0,0,0,0,0,0,0,0,0,0,0,0,0,0,0,0,0,0,0,0,38.759288,-82.024171
West Virginia,MASON,Hartford City Police Department,WV0270500,0,0,0,0,0,0,0,0,0,0,0,0,0,0,0,0,0,0,0,0,0,0,0,0,0,0,0,0,0,0,0,0,0,38.759288,-82.024171
West Virginia,MASON,Department of Natural Resources: Mason County,WV0270700,0,0,0,0,0,0,0,0,0,0,0,0,0,0,0,0,0,0,0,0,0,0,0,0,0,0,0,0,0,0,0,0,0,38.444405,-81.831314
West Virginia,MASON,State Fire Marshal: Mason County,WV0271300,0,0,0,0,0,0,0,0,0,0,0,0,0,0,0,0,0,0,0,0,0,0,0,0,0,0,0,0,0,0,0,0,0,38.34613,-81.63015
West Virginia,MERCER,Mercer County Sheriff's Office,WV0280000,723,266,457,941,326,615,35,7,28,13,5,8,54,15,39,39,15,24,940,127,813,311,66,245,1633,338,1295,96,22,74,2884,531,2353,37.403448,-81.106456
West Virginia,MERCER,Athens Police Department,WV0280100,0,0,0,0,0,0,0,0,0,0,0,0,0,0,0,0,0,0,0,0,0,0,0,0,0,0,0,0,0,0,0,0,0,37.403448,-81.106456
West Virginia,MERCER,Bluefield Police Department,WV0280200,1166,425,741,1276,456,820,17,3,14,0,0,0,53,16,37,9,1,8,228,34,194,63,8,55,574,75,499,69,21,48,865,117,748,37.403448,-81.106456
West Virginia,MERCER,Princeton Police Department,WV0280300,277,107,170,306,111,195,2,1,1,0,0,0,9,1,8,3,1,2,241,25,216,50,10,40,983,322,661,14,2,12,1274,357,917,37.403448,-81.106456
West Virginia,MERCER,Matoaka Police Department,WV0280400,0,0,0,0,0,0,0,0,0,0,0,0,0,0,0,0,0,0,0,0,0,0,0,0,0,0,0,0,0,0,0,0,0,37.403448,-81.106456
West Virginia,MERCER,Bramwell Police Department,WV0280500,0,0,0,0,0,0,0,0,0,0,0,0,0,0,0,0,0,0,0,0,0,0,0,0,0,0,0,0,0,0,0,0,0,37.403448,-81.106456
West Virginia,MERCER,Concord University,WV0280600,0,0,0,0,0,0,0,0,0,0,0,0,0,0,0,0,0,0,3,1,2,0,0,0,5,0,5,0,0,0,8,1,7,37.403448,-81.106456
West Virginia,MERCER,Bluefield State College,WV0280700,0,0,0,0,0,0,0,0,0,0,0,0,0,0,0,0,0,0,0,0,0,0,0,0,0,0,0,0,0,0,0,0,0,37.26821,-81.2356
West Virginia,MERCER,Department of Natural Resources: Mercer County,WV0280800,0,0,0,0,0,0,0,0,0,0,0,0,0,0,0,0,0,0,0,0,0,0,0,0,4,2,2,0,0,0,4,2,2,37.756214,-81.215546
West Virginia,MERCER,State Fire Marshal: Mercer County,WV0281200,0,0,0,0,0,0,5,0,5,0,0,0,0,0,0,0,0,0,0,0,0,0,0,0,0,0,0,0,0,0,0,0,0,38.34613,-81.63015
West Virginia,MERCER,Southern Regional Drug and Violent Crime Task Force,WV0281300,0,0,0,0,0,0,0,0,0,0,0,0,0,0,0,0,0,0,0,0,0,0,0,0,0,0,0,0,0,0,0,0,0,37.403448,-81.106456
West Virginia,MINERAL,Mineral County Sheriff's Office,WV0290000,177,68,109,202,74,128,9,4,5,0,0,0,8,2,6,4,2,2,93,25,68,15,3,12,385,125,260,16,3,13,493,153,340,39.43951,-78.97328
West Virginia,MINERAL,Keyser Police Department,WV0290100,42,16,26,43,16,27,1,0,1,2,1,1,1,0,1,0,0,0,68,13,55,20,3,17,428,91,337,1,0,1,516,107,409,39.437614,-78.97933
West Virginia,MINERAL,Piedmont Police Department,WV0290200,0,0,0,0,0,0,0,0,0,0,0,0,0,0,0,0,0,0,0,0,0,0,0,0,6,3,3,0,0,0,6,3,3,39.405628,-78.956576
West Virginia,MINERAL,Ridgeley Police Department,WV0290300,1,0,1,1,0,1,0,0,0,0,0,0,0,0,0,0,0,0,2,0,2,0,0,0,23,0,23,0,0,0,25,0,25,39.405628,-78.956576
West Virginia,MINERAL,Potomac State College,WV0290500,19,8,11,20,8,12,0,0,0,0,0,0,0,0,0,0,0,0,5,0,5,0,0,0,5,0,5,0,0,0,10,0,10,39.439907,-78.98248
West Virginia,MINERAL,Department of Natural Resources: Mineral County,WV0290600,0,0,0,0,0,0,0,0,0,0,0,0,0,0,0,0,0,0,0,0,0,0,0,0,0,0,0,0,0,0,0,0,0,39.405628,-78.956576
West Virginia,MINERAL,State Fire Marshal: Mineral County,WV0290700,0,0,0,0,0,0,3,1,2,0,0,0,0,0,0,0,0,0,0,0,0,0,0,0,0,0,0,0,0,0,0,0,0,38.34613,-81.63015
West Virginia,MINGO,Mingo County Sheriff's Office,WV0300000,102,46,56,119,54,65,4,2,2,0,0,0,2,1,1,12,6,6,42,20,22,23,9,14,37,16,21,2,1,1,102,45,57,37.721152,-82.158987
West Virginia,MINGO,Gilbert Police Department,WV0300100,4,2,2,4,2,2,1,0,1,0,0,0,0,0,0,0,0,0,4,2,2,6,3,3,8,4,4,0,0,0,18,9,9,37.721152,-82.158987
West Virginia,MINGO,Williamson Police Department,WV0300200,84,27,57,110,37,73,3,1,2,0,0,0,1,0,1,2,1,1,30,6,24,8,1,7,121,20,101,12,3,9,159,27,132,37.721152,-82.158987
West Virginia,MINGO,Kermit Police Department,WV0300300,0,0,0,0,0,0,0,0,0,0,0,0,0,0,0,0,0,0,0,0,0,0,0,0,0,0,0,0,0,0,0,0,0,37.721152,-82.158987
West Virginia,MINGO,Delbarton Police Department,WV0300400,0,0,0,0,0,0,0,0,0,0,0,0,0,0,0,0,0,0,0,0,0,0,0,0,0,0,0,0,0,0,0,0,0,37.721152,-82.158987
West Virginia,MINGO,Matewan Police Department,WV0300500,0,0,0,0,0,0,0,0,0,0,0,0,0,0,0,0,0,0,0,0,0,0,0,0,0,0,0,0,0,0,0,0,0,37.721152,-82.158987
West Virginia,MINGO,Department of Natural Resources: Mingo County,WV0300600,0,0,0,0,0,0,0,0,0,0,0,0,0,0,0,0,0,0,0,0,0,0,0,0,0,0,0,0,0,0,0,0,0,38.444405,-81.831314
West Virginia,MINGO,State Fire Marshal: Mingo County,WV0300900,0,0,0,0,0,0,0,0,0,0,0,0,0,0,0,0,0,0,0,0,0,0,0,0,0,0,0,0,0,0,0,0,0,38.34613,-81.63015
West Virginia,MONONGALIA,Monongalia County Sheriff's Office,WV0310000,931,353,578,1072,376,696,11,3,8,0,0,0,65,5,60,4,2,2,658,58,600,174,24,150,2258,211,2047,91,9,82,3090,293,2797,39.633645,-80.059074
West Virginia,MONONGALIA,Morgantown Police Department,WV0310100,684,266,418,1004,345,659,19,6,13,0,0,0,88,25,63,22,9,13,866,125,741,278,50,228,5059,1006,4053,169,35,134,6203,1181,5022,39.633645,-80.059074
West Virginia,MONONGALIA,Star City Police Department,WV0310300,0,0,0,0,0,0,0,0,0,0,0,0,0,0,0,0,0,0,0,0,0,0,0,0,0,0,0,0,0,0,0,0,0,39.657707,-79.98673
West Virginia,MONONGALIA,Westover Police Department,WV0310400,0,0,0,0,0,0,0,0,0,0,0,0,0,0,0,0,0,0,0,0,0,0,0,0,0,0,0,0,0,0,0,0,0,39.633645,-80.059074
West Virginia,MONONGALIA,West Virginia University,WV0310600,108,31,77,163,42,121,4,0,4,0,0,0,36,7,29,2,1,1,129,16,113,31,11,20,1177,120,1057,40,7,33,1337,147,1190,39.633645,-80.059074
West Virginia,MONONGALIA,Department of Natural Resources: Monongalia County,WV0310700,0,0,0,0,0,0,0,0,0,0,0,0,0,0,0,0,0,0,0,0,0,0,0,0,0,0,0,0,0,0,0,0,0,39.633645,-80.059074
West Virginia,MONONGALIA,Granville Police Department,WV0310900,15,5,10,17,6,11,0,0,0,0,0,0,2,1,1,0,0,0,9,1,8,5,1,4,774,284,490,2,1,1,788,286,502,39.633645,-80.059074
West Virginia,MONONGALIA,State Fire Marshal: Monongalia County,WV0311300,0,0,0,0,0,0,6,2,4,0,0,0,0,0,0,0,0,0,0,0,0,0,0,0,0,0,0,0,0,0,0,0,0,38.34613,-81.63015
West Virginia,MONONGALIA,Mon Valley Drug Task Force,WV0311400,0,0,0,0,0,0,0,0,0,0,0,0,0,0,0,0,0,0,0,0,0,0,0,0,0,0,0,0,0,0,0,0,0,39.62935,-79.95498
West Virginia,MONONGALIA,Mon Metro Drug Task Force,WV0311500,0,0,0,0,0,0,0,0,0,0,0,0,0,0,0,0,0,0,0,0,0,0,0,0,0,0,0,0,0,0,0,0,0,,
West Virginia,MONONGALIA,Morgantown Municipal Fire Marshal,WV0311600,0,0,0,0,0,0,24,1,23,0,0,0,0,0,0,0,0,0,0,0,0,0,0,0,0,0,0,0,0,0,0,0,0,,
West Virginia,MONROE,Monroe County Sheriff's Office,WV0320000,17,7,10,22,8,14,4,0,4,0,0,0,2,0,2,2,1,1,85,8,77,19,2,17,164,4,160,2,0,2,268,14,254,37.550353,-80.547891
West Virginia,"GREENBRIER, MONROE",Alderson Police Department,WV0320100,57,18,39,60,18,42,3,1,2,3,1,2,1,0,1,0,0,0,27,3,24,12,2,10,174,26,148,1,0,1,213,31,182,37.924418,-80.45059
West Virginia,MONROE,Department of Natural Resources: Monroe County,WV0320400,0,0,0,0,0,0,0,0,0,0,0,0,0,0,0,0,0,0,0,0,0,0,0,0,0,0,0,0,0,0,0,0,0,37.756214,-81.215546
West Virginia,MONROE,State Fire Marshal: Monroe County,WV0320800,0,0,0,0,0,0,2,1,1,0,0,0,0,0,0,0,0,0,0,0,0,0,0,0,0,0,0,0,0,0,0,0,0,38.34613,-81.63015
West Virginia,MORGAN,Morgan County Sheriff's Office,WV0330000,428,162,266,463,170,293,4,1,3,0,0,0,16,4,12,1,0,1,140,14,126,21,5,16,283,27,256,27,6,21,444,46,398,39.627377,-78.22861
West Virginia,MORGAN,Berkeley Springs Police Department,WV0330100,0,0,0,0,0,0,0,0,0,0,0,0,0,0,0,0,0,0,0,0,0,0,0,0,0,0,0,0,0,0,0,0,0,39.629463,-78.227196
West Virginia,MORGAN,Paw Paw Police Department,WV0330200,0,0,0,0,0,0,0,0,0,0,0,0,0,0,0,0,0,0,0,0,0,0,0,0,0,0,0,0,0,0,0,0,0,39.554835,-78.257314
West Virginia,MORGAN,Department of Natural Resources: Morgan County,WV0330300,0,0,0,0,0,0,0,0,0,0,0,0,0,0,0,0,0,0,0,0,0,0,0,0,0,0,0,0,0,0,0,0,0,39.554835,-78.257314
West Virginia,MORGAN,State Fire Marshal,WV0330700,0,0,0,0,0,0,1,0,1,0,0,0,0,0,0,0,0,0,0,0,0,0,0,0,0,0,0,0,0,0,0,0,0,,
West Virginia,NICHOLAS,Nicholas County Sheriff's Office,WV0340000,1703,626,1077,1781,643,1138,9,3,6,0,0,0,43,8,35,12,5,7,142,25,117,5,0,5,417,69,348,60,10,50,564,94,470,38.291416,-80.797516
West Virginia,NICHOLAS,Richwood Police Department,WV0340100,0,0,0,0,0,0,0,0,0,0,0,0,0,0,0,0,0,0,0,0,0,0,0,0,0,0,0,0,0,0,0,0,0,38.291416,-80.797516
West Virginia,NICHOLAS,Summersville Police Department,WV0340200,71,33,38,73,33,40,1,0,1,0,0,0,0,0,0,0,0,0,51,14,37,27,6,21,1153,491,662,1,0,1,1231,511,720,38.291416,-80.797516
West Virginia,NICHOLAS,Department of Natural Resources: Nicholas County,WV0340300,0,0,0,0,0,0,0,0,0,0,0,0,0,0,0,0,0,0,0,0,0,0,0,0,0,0,0,0,0,0,0,0,0,38.291416,-80.797516
West Virginia,NICHOLAS,State Fire Marshal: Nicholas County,WV0340400,0,0,0,0,0,0,1,0,1,0,0,0,0,0,0,0,0,0,0,0,0,0,0,0,0,0,0,0,0,0,0,0,0,38.34613,-81.63015
West Virginia,NICHOLAS,Central West Virginia Drug Task Force,WV0340800,0,0,0,0,0,0,0,0,0,0,0,0,0,0,0,0,0,0,0,0,0,0,0,0,0,0,0,0,0,0,0,0,0,38.291416,-80.797516
West Virginia,OHIO,Ohio County Sheriff's Office,WV0350000,462,157,305,552,166,386,4,0,4,0,0,0,49,1,48,1,0,1,337,86,251,70,15,55,1203,341,862,79,4,75,1610,442,1168,40.098932,-80.620728
West Virginia,"MARSHALL, OHIO",Wheeling Police Department,WV0350100,2650,693,1957,3036,742,2294,13,3,10,0,0,0,119,5,114,25,10,15,1434,167,1267,298,32,266,3308,357,2951,154,6,148,5040,556,4484,40.064915,-80.720924
West Virginia,OHIO,Triadelphia Police Department,WV0350200,0,0,0,0,0,0,0,0,0,0,0,0,0,0,0,0,0,0,0,0,0,0,0,0,0,0,0,0,0,0,0,0,0,40.098932,-80.620728
West Virginia,OHIO,Bethlehem Police Department,WV0350300,38,7,31,38,7,31,0,0,0,0,0,0,0,0,0,0,0,0,8,0,8,0,0,0,24,1,23,0,0,0,32,1,31,40.098932,-80.620728
West Virginia,OHIO,West Liberty  Police Department,WV0350400,1,0,1,1,0,1,0,0,0,0,0,0,0,0,0,0,0,0,1,0,1,0,0,0,0,0,0,0,0,0,1,0,1,40.098932,-80.620728
West Virginia,OHIO,West Liberty University,WV0350600,0,0,0,1,0,1,0,0,0,0,0,0,1,0,1,0,0,0,2,0,2,0,0,0,0,0,0,1,0,1,2,0,2,40.098932,-80.620728
West Virginia,OHIO,Department of Natural Resources: Ohio County,WV0350700,2,1,1,2,1,1,0,0,0,0,0,0,0,0,0,0,0,0,0,0,0,0,0,0,0,0,0,0,0,0,0,0,0,40.098932,-80.620728
West Virginia,OHIO,Clearview Police Department,WV0350800,1,0,1,2,0,2,0,0,0,0,0,0,1,0,1,0,0,0,0,0,0,0,0,0,1,0,1,1,0,1,1,0,1,40.137848,-80.69496
West Virginia,OHIO,State Fire Marshal: Ohio County,WV0350900,0,0,0,0,0,0,0,0,0,0,0,0,0,0,0,0,0,0,0,0,0,0,0,0,0,0,0,0,0,0,0,0,0,38.34613,-81.63015
West Virginia,OHIO,Ohio Valley Drug and Violent Crime Task Force,WV0351000,1,0,1,1,0,1,0,0,0,0,0,0,0,0,0,0,0,0,1,0,1,0,0,0,0,0,0,0,0,0,1,0,1,40.064915,-80.720924
West Virginia,PENDLETON,Pendleton County Sheriff's Office,WV0360000,0,0,0,0,0,0,0,0,0,0,0,0,0,0,0,0,0,0,0,0,0,0,0,0,0,0,0,0,0,0,0,0,0,38.674426,-79.340643
West Virginia,PENDLETON,Department of Natural Resources: Pendleton County,WV0360200,0,0,0,0,0,0,2,1,1,0,0,0,0,0,0,0,0,0,0,0,0,0,0,0,0,0,0,0,0,0,0,0,0,38.674426,-79.340643
West Virginia,PENDLETON,State Fire Marshal: Pendleton County,WV0360400,0,0,0,0,0,0,1,0,1,0,0,0,0,0,0,0,0,0,0,0,0,0,0,0,0,0,0,0,0,0,0,0,0,38.34613,-81.63015
West Virginia,PLEASANTS,Pleasants County Sheriff's Office,WV0370000,33,16,17,40,19,21,0,0,0,0,0,0,2,1,1,0,0,0,24,2,22,7,2,5,30,3,27,7,3,4,61,7,54,39.388256,-81.20386
West Virginia,PLEASANTS,St. Marys Police Department,WV0370100,5,0,5,5,0,5,0,0,0,0,0,0,0,0,0,0,0,0,2,1,1,0,0,0,2,0,2,0,0,0,4,1,3,39.368133,-81.161172
West Virginia,PLEASANTS,Department of Natural Resources: Pleasants County,WV0370200,0,0,0,0,0,0,0,0,0,0,0,0,0,0,0,0,0,0,0,0,0,0,0,0,0,0,0,0,0,0,0,0,0,39.282536,-81.549706
West Virginia,PLEASANTS,State Fire Marshal: Pleasants County,WV0370500,0,0,0,0,0,0,0,0,0,0,0,0,0,0,0,0,0,0,0,0,0,0,0,0,0,0,0,0,0,0,0,0,0,38.34613,-81.63015
West Virginia,POCAHONTAS,Pocahontas County Sheriff's Office,WV0380000,76,28,48,82,31,51,1,0,1,0,0,0,0,0,0,4,2,2,52,3,49,13,3,10,99,10,89,2,1,1,164,16,148,38.21807,-80.08867
West Virginia,POCAHONTAS,Marlinton Police Department,WV0380100,0,0,0,0,0,0,0,0,0,0,0,0,0,0,0,0,0,0,0,0,0,0,0,0,0,0,0,0,0,0,0,0,0,38.223824,-80.094124
West Virginia,POCAHONTAS,Department of Natural Resources: Pocahontas County,WV0380200,0,0,0,0,0,0,0,0,0,0,0,0,0,0,0,0,0,0,0,0,0,0,0,0,0,0,0,0,0,0,0,0,0,38.332513,-80.012092
West Virginia,POCAHONTAS,State Fire Marshal: Pocahontas County,WV0380900,0,0,0,0,0,0,2,0,2,0,0,0,0,0,0,0,0,0,0,0,0,0,0,0,0,0,0,0,0,0,0,0,0,38.34613,-81.63015
West Virginia,PRESTON,Preston County Sheriff's Office,WV0390000,317,139,178,375,158,217,5,1,4,0,0,0,16,4,12,14,7,7,141,21,120,115,21,94,730,178,552,28,6,22,986,220,766,39.494675,-79.64265
West Virginia,PRESTON,Kingwood Police Department,WV0390100,0,0,0,0,0,0,0,0,0,0,0,0,0,0,0,0,0,0,0,0,0,0,0,0,0,0,0,0,0,0,0,0,0,39.46794,-79.68984
West Virginia,PRESTON,Terra Alta Police Department,WV0390200,0,0,0,0,0,0,0,0,0,0,0,0,0,0,0,0,0,0,0,0,0,0,0,0,0,0,0,0,0,0,0,0,0,39.45157,-79.55169
West Virginia,PRESTON,Rowlesburg Police Department,WV0390300,0,0,0,0,0,0,0,0,0,0,0,0,0,0,0,0,0,0,0,0,0,0,0,0,0,0,0,0,0,0,0,0,0,39.46903,-79.668865
West Virginia,PRESTON,Masontown Police Department,WV0390400,0,0,0,0,0,0,0,0,0,0,0,0,0,0,0,0,0,0,0,0,0,0,0,0,0,0,0,0,0,0,0,0,0,39.46903,-79.668865
West Virginia,PRESTON,Reedsville Police Department,WV0390700,0,0,0,0,0,0,0,0,0,0,0,0,0,0,0,0,0,0,0,0,0,0,0,0,0,0,0,0,0,0,0,0,0,39.46903,-79.668865
West Virginia,PRESTON,Department of Natural Resources: Preston County,WV0390800,0,0,0,0,0,0,0,0,0,0,0,0,0,0,0,0,0,0,0,0,0,0,0,0,0,0,0,0,0,0,0,0,0,39.46903,-79.668865
West Virginia,PRESTON,State Fire Marshal: Preston County,WV0390900,0,0,0,0,0,0,5,1,4,0,0,0,0,0,0,0,0,0,0,0,0,0,0,0,0,0,0,0,0,0,0,0,0,39.46903,-79.668865
West Virginia,PUTNAM,Putnam County Sheriff's Office,WV0400000,1188,324,864,1282,328,954,15,1,14,0,0,0,47,2,45,4,1,3,503,13,490,327,17,310,1533,37,1496,71,2,69,2363,67,2296,38.510513,-81.906109
West Virginia,PUTNAM,Hurricane Police Department,WV0400100,0,0,0,0,0,0,0,0,0,0,0,0,0,0,0,0,0,0,1,0,1,3,1,2,44,13,31,0,0,0,48,14,34,38.510513,-81.906109
West Virginia,PUTNAM,Winfield Police Department,WV0400200,11,2,9,16,2,14,3,1,2,0,0,0,2,0,2,0,0,0,7,1,6,8,1,7,80,10,70,4,0,4,95,12,83,38.510513,-81.906109
West Virginia,PUTNAM,Eleanor Police Department,WV0400300,0,0,0,0,0,0,0,0,0,0,0,0,0,0,0,0,0,0,0,0,0,0,0,0,0,0,0,0,0,0,0,0,0,38.510513,-81.906109
West Virginia,PUTNAM,Poca Police Department,WV0400400,0,0,0,0,0,0,0,0,0,0,0,0,0,0,0,0,0,0,0,0,0,0,0,0,0,0,0,0,0,0,0,0,0,38.510513,-81.906109
West Virginia,PUTNAM,Department of Natural Resources: Putnam County,WV0400600,0,0,0,0,0,0,0,0,0,0,0,0,0,0,0,0,0,0,0,0,0,0,0,0,0,0,0,0,0,0,0,0,0,38.510513,-81.906109
West Virginia,PUTNAM,State Fire Marshal: Putnam County,WV0400800,0,0,0,0,0,0,0,0,0,0,0,0,0,0,0,0,0,0,0,0,0,0,0,0,0,0,0,0,0,0,0,0,0,38.34613,-81.63015
West Virginia,RALEIGH,Raleigh County Sheriff's Office,WV0410000,961,302,659,1233,346,887,56,11,45,2,0,2,79,6,73,41,14,27,1813,188,1625,347,37,310,3543,475,3068,130,11,119,5703,700,5003,37.78005,-81.16628
West Virginia,RALEIGH,Beckley Police Department,WV0410100,1178,320,858,1575,399,1176,34,7,27,0,0,0,86,5,81,29,13,16,1516,182,1334,380,56,324,9024,2552,6472,148,12,136,10920,2790,8130,37.779095,-81.18071
West Virginia,RALEIGH,Mabscott Police Department,WV0410300,0,0,0,0,0,0,0,0,0,0,0,0,0,0,0,0,0,0,2,0,2,0,0,0,4,0,4,0,0,0,6,0,6,37.76247,-81.264671
West Virginia,RALEIGH,Sophia Police Department,WV0410400,16,5,11,16,5,11,0,0,0,0,0,0,0,0,0,0,0,0,7,0,7,4,2,2,26,5,21,0,0,0,37,7,30,37.76247,-81.264671
West Virginia,RALEIGH,Rhodell Police Department,WV0410500,0,0,0,0,0,0,0,0,0,0,0,0,0,0,0,0,0,0,0,0,0,0,0,0,0,0,0,0,0,0,0,0,0,37.76247,-81.264671
West Virginia,RALEIGH,Department of Natural Resources: Raleigh County,WV0410600,0,0,0,0,0,0,0,0,0,0,0,0,0,0,0,0,0,0,0,0,0,0,0,0,0,0,0,0,0,0,0,0,0,37.756214,-81.215546
West Virginia,RALEIGH,State Fire Marshal: Raleigh County,WV0410900,0,0,0,0,0,0,3,1,2,0,0,0,0,0,0,0,0,0,0,0,0,0,0,0,0,0,0,0,0,0,0,0,0,38.34613,-81.63015
West Virginia,RALEIGH,West Virginia University:,WV0411500,2,1,1,4,2,2,0,0,0,0,0,0,2,1,1,0,0,0,3,0,3,1,0,1,65,2,63,2,1,1,69,2,67,,
West Virginia,RANDOLPH,Randolph County Sheriff's Office,WV0420000,800,291,509,838,301,537,11,3,8,0,0,0,18,3,15,7,2,5,385,65,320,29,9,20,889,260,629,24,6,18,1303,334,969,38.781087,-79.867783
West Virginia,RANDOLPH,Elkins Police Department,WV0420100,0,0,0,0,0,0,0,0,0,0,0,0,0,0,0,0,0,0,0,0,0,0,0,0,0,0,0,0,0,0,0,0,0,38.926384,-79.84951
West Virginia,RANDOLPH,Department of Natural Resources: Randolph County,WV0420300,0,0,0,0,0,0,0,0,0,0,0,0,0,0,0,0,0,0,0,0,0,0,0,0,0,0,0,0,0,0,0,0,0,38.781087,-79.867783
West Virginia,RANDOLPH,State Fire Marshal: Randolph County,WV0421000,0,0,0,0,0,0,4,1,3,0,0,0,0,0,0,0,0,0,0,0,0,0,0,0,0,0,0,0,0,0,0,0,0,38.34613,-81.63015
West Virginia,RITCHIE,Ritchie County Sheriff's Office,WV0430000,8,1,7,14,1,13,4,0,4,0,0,0,3,0,3,0,0,0,24,0,24,4,0,4,159,0,159,5,0,5,187,0,187,39.21049,-81.05187
West Virginia,RITCHIE,Harrisville Police Department,WV0430100,0,0,0,0,0,0,0,0,0,0,0,0,0,0,0,0,0,0,0,0,0,0,0,0,0,0,0,0,0,0,0,0,0,39.177112,-81.066317
West Virginia,RITCHIE,Pennsboro Police Department,WV0430200,0,0,0,0,0,0,0,0,0,0,0,0,0,0,0,0,0,0,0,0,0,0,0,0,6,2,4,0,0,0,6,2,4,39.177112,-81.066317
West Virginia,RITCHIE,Department of Natural Resources: Ritchie County,WV0430400,0,0,0,0,0,0,0,0,0,0,0,0,0,0,0,0,0,0,0,0,0,0,0,0,0,0,0,0,0,0,0,0,0,39.282536,-81.549706
West Virginia,RITCHIE,State Fire Marshal: Ritchie County,WV0430700,0,0,0,0,0,0,0,0,0,0,0,0,0,0,0,0,0,0,0,0,0,0,0,0,0,0,0,0,0,0,0,0,0,39.177112,-81.066317
West Virginia,ROANE,Roane County Sheriff's Office,WV0440000,159,76,83,172,81,91,3,0,3,0,0,0,0,0,0,2,1,1,5,1,4,27,5,22,245,54,191,10,4,6,277,60,217,38.79928,-81.34241
West Virginia,ROANE,Spencer Police Department,WV0440100,41,18,23,46,19,27,1,0,1,0,0,0,4,1,3,0,0,0,16,5,11,3,0,3,337,142,195,4,1,3,356,147,209,38.801777,-81.34855
West Virginia,ROANE,Department of Natural Resources: Roane County,WV0440200,0,0,0,0,0,0,0,0,0,0,0,0,0,0,0,0,0,0,0,0,0,0,0,0,0,0,0,0,0,0,0,0,0,39.282536,-81.549706
West Virginia,ROANE,State Fire Marshal: Roane County,WV0440300,0,0,0,0,0,0,2,0,2,0,0,0,0,0,0,0,0,0,0,0,0,0,0,0,0,0,0,0,0,0,0,0,0,38.34613,-81.63015
West Virginia,SUMMERS,Summers County Sheriff's Office,WV0450000,117,40,77,127,41,86,2,1,1,0,0,0,2,0,2,0,0,0,78,3,75,27,2,25,100,5,95,9,1,8,205,10,195,37.656003,-80.856315
West Virginia,SUMMERS,Hinton Police Department,WV0450100,8,4,4,12,5,7,5,2,3,0,0,0,2,1,1,1,0,1,17,2,15,6,1,5,55,15,40,2,1,1,78,18,60,37.656003,-80.856315
West Virginia,SUMMERS,Department of Natural Resources: Summers County,WV0450200,0,0,0,0,0,0,0,0,0,0,0,0,0,0,0,0,0,0,0,0,0,0,0,0,0,0,0,0,0,0,0,0,0,37.756214,-81.215546
West Virginia,SUMMERS,State Fire Marshal: Summers County,WV0450700,0,0,0,0,0,0,2,0,2,0,0,0,0,0,0,0,0,0,0,0,0,0,0,0,0,0,0,0,0,0,0,0,0,38.34613,-81.63015
West Virginia,TAYLOR,Taylor County Sheriff's Office,WV0460000,0,0,0,0,0,0,0,0,0,0,0,0,0,0,0,0,0,0,3,0,3,0,0,0,6,0,6,0,0,0,9,0,9,39.332477,-80.046554
West Virginia,TAYLOR,Grafton Police Department,WV0460100,19,7,12,22,8,14,1,0,1,0,0,0,0,0,0,0,0,0,67,16,51,25,3,22,171,37,134,2,1,1,263,56,207,39.341236,-80.018654
West Virginia,TAYLOR,Department of Natural Resources: Taylor County,WV0460300,0,0,0,0,0,0,0,0,0,0,0,0,0,0,0,0,0,0,0,0,0,0,0,0,0,0,0,0,0,0,0,0,0,39.332477,-80.046554
West Virginia,TAYLOR,State Fire Marshal: Taylor County,WV0460700,0,0,0,0,0,0,5,1,4,0,0,0,0,0,0,0,0,0,0,0,0,0,0,0,0,0,0,0,0,0,0,0,0,38.34613,-81.63015
West Virginia,TUCKER,Tucker County Sheriff's Office,WV0470000,8,4,4,8,4,4,0,0,0,0,0,0,0,0,0,0,0,0,2,0,2,0,0,0,2,1,1,0,0,0,4,1,3,39.09689,-79.68106
West Virginia,TUCKER,Parsons Police Department,WV0470100,0,0,0,0,0,0,0,0,0,0,0,0,0,0,0,0,0,0,0,0,0,0,0,0,0,0,0,0,0,0,0,0,0,39.111175,-79.559968
West Virginia,TUCKER,Department of Natural Resources: Tucker County,WV0470300,0,0,0,0,0,0,0,0,0,0,0,0,0,0,0,0,0,0,0,0,0,0,0,0,0,0,0,0,0,0,0,0,0,39.111175,-79.559968
West Virginia,TUCKER,State Fire Marshal: Tucker County,WV0470900,0,0,0,0,0,0,0,0,0,0,0,0,0,0,0,0,0,0,0,0,0,0,0,0,0,0,0,0,0,0,0,0,0,38.34613,-81.63015
West Virginia,TYLER,Tyler County Sheriff's Office,WV0480000,58,16,42,68,17,51,3,0,3,0,0,0,2,0,2,3,1,2,42,3,39,5,1,4,66,5,61,6,0,6,113,9,104,39.465981,-80.879493
West Virginia,"TYLER, WETZEL",Paden City Police Department,WV0480100,0,0,0,0,0,0,0,0,0,0,0,0,0,0,0,0,0,0,0,0,0,0,0,0,0,0,0,0,0,0,0,0,0,39.596574,-80.634394
West Virginia,TYLER,Sistersville Police Department,WV0480200,3,0,3,3,0,3,0,0,0,0,0,0,0,0,0,0,0,0,3,0,3,0,0,0,1,0,1,0,0,0,4,0,4,39.465981,-80.879493
West Virginia,TYLER,Department of Natural Resources: Tyler County,WV0480500,0,0,0,0,0,0,0,0,0,0,0,0,0,0,0,0,0,0,0,0,0,0,0,0,0,0,0,0,0,0,0,0,0,39.465981,-80.879493
West Virginia,TYLER,State Fire Marshal: Tyler County,WV0480600,0,0,0,0,0,0,0,0,0,0,0,0,0,0,0,0,0,0,0,0,0,0,0,0,0,0,0,0,0,0,0,0,0,38.34613,-81.63015
West Virginia,UPSHUR,Upshur County Sheriff's Office,WV0490000,41,15,26,61,18,43,17,6,11,0,0,0,12,0,12,4,2,2,59,7,52,54,7,47,203,18,185,13,1,12,316,32,284,38.99408,-80.22932
West Virginia,UPSHUR,Buckhannon Police Department,WV0490100,39,16,23,61,22,39,9,2,7,0,0,0,13,4,9,0,0,0,83,16,67,45,11,34,1777,688,1089,18,5,13,1905,715,1190,38.993168,-80.23367
West Virginia,UPSHUR,Department of Natural Resources: Upshur County,WV0490200,0,0,0,0,0,0,0,0,0,0,0,0,0,0,0,0,0,0,0,0,0,0,0,0,0,0,0,0,0,0,0,0,0,38.902536,-80.231335
West Virginia,UPSHUR,State Fire Marshal: Upshur County,WV0490400,0,0,0,0,0,0,1,0,1,0,0,0,0,0,0,0,0,0,0,0,0,0,0,0,0,0,0,0,0,0,0,0,0,38.34613,-81.63015
West Virginia,WAYNE,Wayne County Sheriff's Office,WV0500000,24,7,17,27,7,20,0,0,0,0,0,0,0,0,0,0,0,0,47,2,45,7,0,7,42,2,40,1,0,1,96,4,92,38.145531,-82.419698
West Virginia,WAYNE,Ceredo Police Department,WV0500100,34,13,21,35,13,22,1,0,1,0,0,0,1,0,1,0,0,0,18,3,15,10,3,7,75,11,64,1,0,1,103,17,86,38.145531,-82.419698
West Virginia,WAYNE,Kenova Police Department,WV0500200,10,3,7,29,5,24,8,1,7,0,0,0,5,1,4,0,0,0,37,3,34,53,7,46,421,40,381,11,2,9,511,50,461,38.145531,-82.419698
West Virginia,WAYNE,Wayne Police Department,WV0500300,0,0,0,0,0,0,0,0,0,0,0,0,0,0,0,0,0,0,0,0,0,0,0,0,0,0,0,0,0,0,0,0,0,38.145531,-82.419698
West Virginia,WAYNE,Fort Gay Police Department,WV0500400,0,0,0,0,0,0,0,0,0,0,0,0,0,0,0,0,0,0,0,0,0,0,0,0,0,0,0,0,0,0,0,0,0,38.145531,-82.419698
West Virginia,WAYNE,Department of Natural Resources: Wayne County,WV0500500,0,0,0,0,0,0,0,0,0,0,0,0,0,0,0,0,0,0,0,0,0,0,0,0,2,1,1,0,0,0,2,1,1,38.444405,-81.831314
West Virginia,WAYNE,State Fire Marshal: Wayne County,WV0500900,0,0,0,0,0,0,0,0,0,0,0,0,0,0,0,0,0,0,0,0,0,0,0,0,0,0,0,0,0,0,0,0,0,38.34613,-81.63015
West Virginia,WEBSTER,Webster County Sheriff's Office,WV0510000,7,3,4,7,3,4,2,1,1,0,0,0,0,0,0,0,0,0,9,4,5,5,1,4,19,7,12,0,0,0,33,12,21,38.492985,-80.430262
West Virginia,WEBSTER,Webster Springs Police Department,WV0510100,0,0,0,0,0,0,0,0,0,0,0,0,0,0,0,0,0,0,0,0,0,0,0,0,0,0,0,0,0,0,0,0,0,38.492985,-80.430262
West Virginia,WEBSTER,Department of Natural Resources: Webster County,WV0510400,0,0,0,0,0,0,0,0,0,0,0,0,0,0,0,0,0,0,0,0,0,0,0,0,0,0,0,0,0,0,0,0,0,38.492985,-80.430262
West Virginia,WEBSTER,State Fire Marshal: Webster County,WV0510800,0,0,0,0,0,0,0,0,0,0,0,0,0,0,0,0,0,0,0,0,0,0,0,0,0,0,0,0,0,0,0,0,0,38.34613,-81.63015
West Virginia,WETZEL,Wetzel County Sheriff's Office,WV0520000,230,98,132,243,101,142,6,2,4,0,0,0,9,2,7,0,0,0,121,29,92,31,12,19,117,24,93,11,2,9,269,65,204,39.596574,-80.634394
West Virginia,WETZEL,Hundred Police Department,WV0520100,0,0,0,0,0,0,0,0,0,0,0,0,0,0,0,0,0,0,0,0,0,0,0,0,0,0,0,0,0,0,0,0,0,39.596574,-80.634394
West Virginia,WETZEL,New Martinsville Police Department,WV0520200,24,10,14,25,10,15,0,0,0,0,0,0,0,0,0,0,0,0,39,5,34,22,5,17,87,27,60,0,0,0,148,37,111,39.63997,-80.86585
West Virginia,WETZEL,Department of Natural Resources: Wetzel County,WV0520700,0,0,0,0,0,0,0,0,0,0,0,0,0,0,0,0,0,0,0,0,0,0,0,0,0,0,0,0,0,0,0,0,0,39.596574,-80.634394
West Virginia,WETZEL,State Fire Marshal: Wetzel County,WV0520800,0,0,0,0,0,0,0,0,0,0,0,0,0,0,0,0,0,0,0,0,0,0,0,0,0,0,0,0,0,0,0,0,0,38.34613,-81.63015
West Virginia,WIRT,Wirt County Sheriff's Office,WV0530000,62,13,49,66,13,53,10,0,10,0,0,0,3,0,3,0,0,0,85,3,82,11,1,10,113,5,108,4,0,4,209,9,200,39.020034,-81.382975
West Virginia,WIRT,Department of Natural Resources: Wirt County,WV0530200,0,0,0,0,0,0,0,0,0,0,0,0,0,0,0,0,0,0,0,0,0,0,0,0,0,0,0,0,0,0,0,0,0,39.282536,-81.549706
West Virginia,WIRT,State Fire Marshal: Wirt County,WV0530300,0,0,0,0,0,0,0,0,0,0,0,0,0,0,0,0,0,0,0,0,0,0,0,0,0,0,0,0,0,0,0,0,0,38.34613,-81.63015
West Virginia,WOOD,Wood County Sheriff's Office,WV0540000,760,220,540,878,227,651,26,1,25,0,0,0,57,2,55,10,2,8,726,43,683,286,24,262,1726,169,1557,94,4,90,2738,236,2502,39.211679,-81.515928
West Virginia,WOOD,Parkersburg Police Department,WV0540100,1141,308,833,1541,369,1172,166,14,152,0,0,0,163,19,144,33,11,22,2735,175,2560,903,107,796,8039,744,7295,219,23,196,11677,1026,10651,39.211679,-81.515928
West Virginia,WOOD,Vienna Police Department,WV0540200,163,53,110,199,57,142,3,0,3,0,0,0,13,1,12,0,0,0,210,13,197,51,6,45,3800,867,2933,27,2,25,4061,886,3175,39.211679,-81.515928
West Virginia,WOOD,Williamstown Police Department,WV0540300,55,19,36,56,19,37,0,0,0,0,0,0,0,0,0,1,0,1,17,5,12,12,1,11,35,4,31,0,0,0,64,10,54,39.400513,-81.44848
West Virginia,WOOD,Department of Natural Resources: Wood County,WV0540400,2,1,1,2,1,1,0,0,0,0,0,0,0,0,0,0,0,0,0,0,0,0,0,0,0,0,0,0,0,0,0,0,0,39.282536,-81.549706
West Virginia,WOOD,State Fire Marshal: Wood County,WV0540500,0,0,0,0,0,0,5,2,3,0,0,0,0,0,0,0,0,0,0,0,0,0,0,0,0,0,0,0,0,0,0,0,0,38.34613,-81.63015
West Virginia,WOOD,Parkersburg Narcotics and Violent Crime Task Force,WV0540800,2,1,1,3,1,2,0,0,0,0,0,0,0,0,0,1,0,1,0,0,0,0,0,0,2,0,2,0,0,0,2,0,2,39.211679,-81.515928
West Virginia,WYOMING,Wyoming County Sheriff's Office,WV0550000,777,259,518,793,260,533,13,2,11,0,0,0,7,1,6,0,0,0,225,28,197,51,1,50,336,9,327,13,1,12,612,38,574,37.603717,-81.548884
West Virginia,WYOMING,Mullens Police Department,WV0550100,15,7,8,19,9,10,2,0,2,0,0,0,2,1,1,0,0,0,29,8,21,8,2,6,82,17,65,2,1,1,119,27,92,37.603717,-81.548884
West Virginia,WYOMING,Pineville Police Department,WV0550200,0,0,0,0,0,0,0,0,0,0,0,0,0,0,0,0,0,0,0,0,0,0,0,0,0,0,0,0,0,0,0,0,0,37.603717,-81.548884
West Virginia,WYOMING,Oceana Police Department,WV0550300,27,0,27,28,0,28,0,0,0,0,0,0,1,0,1,0,0,0,6,0,6,2,0,2,29,0,29,1,0,1,37,0,37,37.603717,-81.548884
West Virginia,WYOMING,Department of Natural Resources: Wyoming County,WV0550400,0,0,0,0,0,0,0,0,0,0,0,0,0,0,0,0,0,0,0,0,0,0,0,0,0,0,0,0,0,0,0,0,0,37.756214,-81.215546
West Virginia,WYOMING,State Fire Marshal: Wyoming County,WV0550500,0,0,0,0,0,0,0,0,0,0,0,0,0,0,0,0,0,0,0,0,0,0,0,0,0,0,0,0,0,0,0,0,0,38.34613,-81.63015
West Virginia,UNMAPPED COUNTY,State Police,WVWSP0000,0,0,0,0,0,0,0,0,0,0,0,0,0,0,0,0,0,0,1,0,1,2,1,1,2,1,1,0,0,0,5,2,3,38.35813,-81.71573
West Virginia,RALEIGH,State Police: Beckley,WVWSP0100,319,145,174,449,189,260,2,1,1,15,6,9,46,13,33,8,3,5,502,94,408,247,56,191,1876,350,1526,117,39,78,2625,500,2125,37.78485,-81.16557
West Virginia,MORGAN,State Police: Berkeley Springs,WVWSP0200,50,22,28,89,30,59,3,1,2,6,1,5,17,0,17,0,0,0,96,10,86,62,10,52,367,56,311,34,6,28,525,76,449,39.58791,-78.24871
West Virginia,UPSHUR,State Police: Buckhannon,WVWSP0400,33,14,19,77,24,53,4,1,3,9,2,7,17,2,15,0,0,0,160,33,127,69,11,58,368,50,318,40,8,32,597,94,503,38.952805,-80.24769
West Virginia,JEFFERSON,State Police: Kearneysville,WVWSP0500,71,28,43,111,38,73,4,1,3,0,0,0,12,2,10,4,2,2,130,16,114,31,5,26,706,183,523,27,6,21,867,204,663,39.307398,-77.86322
West Virginia,KANAWHA,State Police: Quincy,WVWSP0600,175,75,100,222,86,136,17,7,10,0,0,0,17,3,14,6,2,4,151,19,132,108,13,95,874,141,733,33,5,28,1133,173,960,38.204002,-81.502304
West Virginia,HARRISON,State Police: Bridgeport,WVWSP0700,80,36,44,158,56,102,3,0,3,0,0,0,35,7,28,6,2,4,228,29,199,147,22,125,728,75,653,69,18,51,1103,126,977,39.279182,-80.386498
West Virginia,CLAY,State Police: Clay,WVWSP0800,164,72,92,235,98,137,20,5,15,0,0,0,24,8,16,17,7,10,326,55,271,156,30,126,365,63,302,39,13,26,847,148,699,38.459826,-81.081866
West Virginia,RANDOLPH,State Police: Elkins,WVWSP1000,190,79,111,291,104,187,8,1,7,6,0,6,40,7,33,6,3,3,232,21,211,84,19,65,979,299,680,91,21,70,1295,339,956,38.781087,-79.867783
West Virginia,MARION,State Police: Fairmont,WVWSP1100,83,30,53,136,45,91,2,1,1,1,0,1,21,6,15,8,4,4,224,24,200,94,20,74,362,46,316,44,11,33,680,90,590,39.470646,-80.1675
West Virginia,PENDLETON,State Police: Franklin,WVWSP1200,89,37,52,105,41,64,12,3,9,0,0,0,4,1,3,7,2,5,136,30,106,31,11,20,126,30,96,7,1,6,293,71,222,38.674426,-79.340643
West Virginia,GILMER,State Police: Glenville,WVWSP1300,181,85,96,240,107,133,8,2,6,4,0,4,30,9,21,6,3,3,106,14,92,51,10,41,159,29,130,53,19,34,316,53,263,38.915865,-80.849409
West Virginia,TAYLOR,State Police: Grafton,WVWSP1400,27,11,16,46,15,31,0,0,0,0,0,0,13,3,10,3,1,2,69,7,62,14,1,13,91,13,78,16,3,13,174,21,153,39.332477,-80.046554
West Virginia,CALHOUN,State Police: Grantsville,WVWSP1500,68,29,39,85,31,54,12,4,8,3,0,3,6,1,5,2,0,2,74,9,65,25,5,20,144,18,126,13,2,11,243,32,211,38.869686,-81.10109
West Virginia,LINCOLN,State Police: Hamlin,WVWSP1600,405,169,236,558,208,350,27,10,17,4,0,4,69,15,54,12,5,7,514,103,411,570,183,387,1051,172,879,131,32,99,2135,458,1677,38.278873,-82.10474
West Virginia,RITCHIE,State Police: Harrisville,WVWSP1700,64,25,39,88,31,57,5,2,3,10,5,5,14,2,12,4,2,2,100,13,87,36,6,30,190,26,164,20,4,16,326,45,281,39.177112,-81.066317
West Virginia,SUMMERS,State Police: Hinton,WVWSP1800,68,30,38,93,37,56,6,2,4,3,1,2,11,2,9,8,3,5,124,25,99,42,7,35,155,21,134,15,3,12,321,53,268,37.656003,-80.856315
West Virginia,CABELL,State Police: Huntington,WVWSP1900,198,75,123,451,115,336,3,0,3,12,1,11,135,18,117,6,3,3,546,62,484,209,40,169,2438,625,1813,232,32,200,3193,727,2466,38.40278,-82.50508
West Virginia,MINERAL,State Police: Keyser,WVWSP2000,125,50,75,201,73,128,1,0,1,2,0,2,29,9,20,6,1,5,277,53,224,107,37,70,881,205,676,63,20,43,1265,295,970,39.405628,-78.956576
West Virginia,PRESTON,State Police: Kingwood,WVWSP2100,196,87,109,270,108,162,12,3,9,2,1,1,32,7,25,12,6,6,227,25,202,128,28,100,497,90,407,56,13,43,852,143,709,39.46903,-79.668865
West Virginia,GREENBRIER,State Police: Lewisburg,WVWSP2200,65,28,37,101,37,64,5,1,4,0,0,0,14,2,12,0,0,0,150,24,126,77,16,61,589,72,517,32,7,25,816,112,704,37.801872,-80.43713
West Virginia,LOGAN,State Police: Logan,WVWSP2300,348,154,194,498,198,300,18,4,14,9,2,7,40,11,29,5,2,3,381,84,297,204,43,161,922,191,731,99,26,73,1507,318,1189,37.830591,-81.940853
West Virginia,BOONE,State Police: Madison,WVWSP2400,160,70,90,210,87,123,8,2,6,0,0,0,26,7,19,10,5,5,189,41,148,192,45,147,676,105,571,37,11,26,1057,191,866,38.022838,-81.713314
West Virginia,POCAHONTAS,State Police: Marlinton,WVWSP2500,114,50,64,153,61,92,16,6,10,1,0,1,13,2,11,13,6,7,133,29,104,61,17,44,320,82,238,26,5,21,514,128,386,38.332513,-80.012092
West Virginia,BERKELEY,State Police: Martinsburg,WVWSP2600,285,104,181,576,161,415,37,11,26,46,8,38,147,25,122,18,8,10,592,60,532,282,51,231,2123,346,1777,237,43,194,2997,457,2540,39.48895,-77.95912
West Virginia,FAYETTE,State Police: Gauley Bridge,WVWSP2700,30,12,18,39,15,24,1,0,1,1,0,1,1,0,1,3,1,2,24,4,20,26,6,20,107,18,89,5,2,3,157,28,129,38.030933,-81.086051
West Virginia,HARDY,State Police: Moorefield,WVWSP2800,187,79,108,250,96,154,0,0,0,7,3,4,39,11,28,0,0,0,187,38,149,99,26,73,336,63,273,61,17,44,622,127,495,39.010818,-78.843641
West Virginia,MONONGALIA,State Police: Morgantown,WVWSP2900,174,73,101,310,108,202,4,2,2,5,2,3,53,12,41,10,5,5,586,57,529,201,32,169,1563,210,1353,98,23,75,2350,299,2051,39.65507,-79.98632
West Virginia,MARSHALL,State Police: Moundsville,WVWSP3000,93,45,48,154,67,87,0,0,0,6,2,4,23,7,16,3,1,2,45,15,30,21,6,15,72,13,59,54,19,35,138,34,104,39.906162,-80.75573
West Virginia,FAYETTE,State Police: Oak Hill,WVWSP3100,90,39,51,133,49,84,11,3,8,3,0,3,12,1,11,4,1,3,123,21,102,63,10,53,418,47,371,37,8,29,604,78,526,38.000908,-81.13132
West Virginia,TYLER,State Police: Paden City,WVWSP3200,59,18,41,131,32,99,4,1,3,8,2,6,36,5,31,3,1,2,104,21,83,37,8,29,163,33,130,65,11,54,304,62,242,39.465981,-80.879493
West Virginia,WOOD,State Police: Parkersburg,WVWSP3300,75,27,48,173,40,133,4,1,3,9,3,6,56,6,50,1,0,1,352,39,313,81,14,67,515,66,449,96,13,83,948,119,829,39.2157,-81.50146
West Virginia,TUCKER,State Police: Parsons,WVWSP3400,63,30,33,83,36,47,2,0,2,0,0,0,6,1,5,3,1,2,77,7,70,14,3,11,154,35,119,14,4,10,245,45,200,39.111175,-79.559968
West Virginia,BARBOUR,State Police: Philippi,WVWSP3600,224,106,118,267,119,148,6,2,4,2,1,1,23,7,16,4,1,3,164,25,139,64,19,45,256,36,220,35,11,24,484,80,404,39.139725,-79.996947
West Virginia,WYOMING,State Police: Jesse,WVWSP3700,104,50,54,156,63,93,2,0,2,3,0,3,23,5,18,0,0,0,108,25,83,34,5,29,156,34,122,49,12,37,298,64,234,37.603717,-81.548884
West Virginia,MASON,State Police: Point Pleasant,WVWSP3800,73,34,39,110,42,68,4,1,3,5,1,4,22,4,18,2,1,1,140,27,113,72,19,53,231,41,190,34,7,27,443,87,356,38.759288,-82.024171
West Virginia,MERCER,State Police: Princeton,WVWSP3900,251,106,145,334,132,202,9,3,6,0,0,0,25,6,19,11,5,6,338,44,294,180,30,150,1615,298,1317,45,10,35,2133,372,1761,37.36488,-81.05041
West Virginia,GREENBRIER,State Police: Rainelle,WVWSP4000,95,45,50,117,52,65,4,2,2,1,0,1,4,0,4,7,2,5,215,27,188,43,10,33,317,45,272,12,4,8,575,82,493,37.924418,-80.45059
West Virginia,NICHOLAS,State Police: Richwood,WVWSP4100,70,29,41,82,32,50,3,1,2,0,0,0,8,2,6,3,1,2,136,31,105,62,12,50,279,45,234,9,2,7,477,88,389,38.291416,-80.797516
West Virginia,JACKSON,State Police: Ripley,WVWSP4200,47,22,25,73,28,45,5,2,3,1,0,1,20,3,17,0,0,0,108,14,94,59,14,45,304,48,256,26,6,20,471,76,395,38.834234,-81.677717
West Virginia,HAMPSHIRE,State Police: Romney,WVWSP4300,104,46,58,155,64,91,0,0,0,3,0,3,21,8,13,0,0,0,85,12,73,23,7,16,257,30,227,50,18,32,365,49,316,39.312139,-78.611989
West Virginia,PLEASANTS,State Police: St. Marys,WVWSP4400,29,9,20,40,10,30,1,0,1,0,0,0,7,1,6,0,0,0,28,6,22,10,4,6,39,5,34,11,1,10,77,15,62,39.368133,-81.161172
West Virginia,KANAWHA,State Police: South Charleston,WVWSP4600,146,55,91,333,80,253,5,1,4,3,1,2,98,10,88,8,4,4,244,30,214,251,40,211,2367,71,2296,174,20,154,2862,141,2721,38.358162,-81.71576
West Virginia,ROANE,State Police: Spencer,WVWSP4700,177,81,96,219,97,122,5,2,3,5,2,3,21,8,13,4,2,2,110,30,80,91,24,67,171,36,135,34,13,21,372,90,282,38.79324,-81.30709
West Virginia,NICHOLAS,State Police: Summersville,WVWSP4800,113,51,62,132,56,76,5,1,4,4,1,3,6,1,5,8,3,5,103,16,87,65,8,57,374,42,332,8,1,7,542,66,476,38.291416,-80.797516
West Virginia,BRAXTON,State Police: Sutton,WVWSP4900,145,62,83,212,75,137,21,6,15,5,1,4,33,5,28,5,1,4,165,27,138,104,16,88,557,144,413,55,10,45,826,187,639,38.699302,-80.731649
West Virginia,OHIO,State Police: Wheeling,WVWSP5000,18,7,11,45,15,30,1,0,1,1,0,1,10,1,9,1,0,1,14,4,10,9,4,5,91,27,64,22,6,16,114,35,79,40.05491,-80.72405
West Virginia,MONROE,State Police: Union,WVWSP5100,73,35,38,112,51,61,2,0,2,0,0,0,15,5,10,11,4,7,124,23,101,35,11,24,180,31,149,28,12,16,339,65,274,37.550353,-80.547891
West Virginia,WAYNE,State Police: Wayne,WVWSP5200,327,125,202,432,152,280,28,5,23,2,0,2,49,9,40,10,4,6,613,60,553,375,63,312,1541,330,1211,83,19,64,2529,453,2076,38.145531,-82.419698
West Virginia,WEBSTER,State Police: Upperglade,WVWSP5300,304,146,158,327,156,171,3,1,2,1,0,1,11,4,7,0,0,0,151,44,107,66,17,49,212,48,164,19,8,11,429,109,320,38.492985,-80.430262
West Virginia,MCDOWELL,State Police: Welch,WVWSP5500,302,138,164,400,178,222,17,5,12,4,2,2,21,6,15,17,8,9,232,48,184,80,15,65,328,86,242,59,24,35,640,149,491,37.382663,-81.658205
West Virginia,BROOKE,State Police: Wellsburg,WVWSP5600,69,27,42,113,36,77,0,0,0,3,0,3,31,6,25,0,0,0,10,2,8,5,2,3,56,10,46,42,8,34,71,14,57,40.27546,-80.60856
West Virginia,LEWIS,State Police: Weston,WVWSP5700,100,45,55,152,58,94,4,1,3,3,1,2,28,5,23,1,0,1,143,18,125,80,21,59,577,154,423,43,9,34,800,193,607,38.988877,-80.495477
West Virginia,DODDRIDGE,State Police: West Union,WVWSP5800,56,20,36,94,29,65,3,0,3,4,1,3,12,4,8,1,0,1,68,10,58,40,6,34,118,12,106,35,8,27,226,28,198,39.263482,-80.701147
West Virginia,BOONE,State Police: Whitesville,WVWSP5900,71,30,41,85,35,50,1,0,1,5,2,3,2,0,2,4,2,2,135,26,109,42,7,35,193,29,164,6,1,5,370,62,308,38.022838,-81.713314
West Virginia,MINGO,State Police: Williamson,WVWSP6000,257,114,143,349,143,206,21,5,16,7,2,5,45,12,33,14,7,7,204,41,163,192,33,159,407,51,356,64,17,47,803,125,678,37.721152,-82.158987
West Virginia,PUTNAM,State Police: Winfield,WVWSP6100,97,38,59,140,47,93,4,0,4,1,0,1,27,5,22,0,0,0,150,27,123,102,11,91,673,51,622,35,6,29,925,89,836,38.510513,-81.906109
West Virginia,KANAWHA,"State Police, Parkway Authority: Kanawha County",WVWSP6200,2,1,1,7,3,4,0,0,0,0,0,0,3,1,2,0,0,0,0,0,0,0,0,0,15,5,10,5,2,3,15,5,10,,
West Virginia,HANCOCK,State Police: New Cumberland,WVWSP6600,25,6,19,53,13,40,0,0,0,0,0,0,14,3,11,0,0,0,1,0,1,7,3,4,35,5,30,28,7,21,43,8,35,40.516958,-80.570164
West Virginia,MERCER,"State Police, Parkway Authority: Mercer County",WVWSP6700,4,2,2,4,2,2,0,0,0,0,0,0,0,0,0,0,0,0,3,1,2,2,1,1,6,3,3,0,0,0,11,5,6,,
West Virginia,FAYETTE,"State Police, Parkway Authority: Fayette County",WVWSP6800,0,0,0,0,0,0,0,0,0,0,0,0,0,0,0,0,0,0,0,0,0,0,0,0,5,0,5,0,0,0,5,0,5,,
West Virginia,RALEIGH,"State Police, Parkway Authority: Raleigh County",WVWSP6900,0,0,0,2,0,2,0,0,0,0,0,0,0,0,0,0,0,0,1,0,1,6,3,3,26,3,23,1,0,1,33,6,27,,
West Virginia,KANAWHA,"State Police, Bureau of Criminal Investigations: Charleston",WVWSP8500,2,1,1,2,1,1,0,0,0,0,0,0,0,0,0,0,0,0,0,0,0,2,1,1,10,1,9,0,0,0,12,2,10,38.35813,-81.71573
West Virginia,MARION,"State Police, Bureau of Criminal Investigations: Fairmont",WVWSP8600,0,0,0,0,0,0,0,0,0,0,0,0,0,0,0,0,0,0,0,0,0,0,0,0,0,0,0,0,0,0,0,0,0,,
West Virginia,BERKELEY,"State Police, Bureau of Criminal Investigations: Martinsburg",WVWSP8700,0,0,0,0,0,0,0,0,0,0,0,0,0,0,0,0,0,0,0,0,0,0,0,0,0,0,0,0,0,0,0,0,0,,
West Virginia,RALEIGH,"State Police, Bureau of Criminal Investigations: Beckley",WVWSP8800,0,0,0,1,0,1,0,0,0,0,0,0,0,0,0,1,0,1,0,0,0,0,0,0,1,0,1,0,0,0,1,0,1,,
West Virginia,UPSHUR,"State Police, Bureau of Criminal Investigations: Buckhannon",WVWSP9000,0,0,0,0,0,0,0,0,0,0,0,0,0,0,0,0,0,0,0,0,0,0,0,0,0,0,0,0,0,0,0,0,0,38.994877,-80.23075
West Virginia,MERCER,"State Police, Bureau of Criminal Investigations: Bluefield",WVWSP9300,1,0,1,3,1,2,0,0,0,0,0,0,0,0,0,0,0,0,0,0,0,0,0,0,2,0,2,0,0,0,2,0,2,,
West Virginia,MONONGALIA,State Police: Internet Crimes Against Children Unit,WVWSP9800,40,18,22,200,71,129,0,0,0,1,0,1,55,11,44,1,1,0,0,0,0,0,0,0,5,0,5,159,52,107,5,0,5,39.65336,-79.968735
